"POSTAL_CODE","RANK","SCORE","DWELLINGS TOTAL","ACCUM. DWELLINGS","PT_DOG_%","PT_DOG_#","HHI over $100,000_%","HHI over $100,000_#"
M5M2E3,1,194,6,6,29.32,2,91.59,5
M5M3K9,2,194,9,15,29.32,3,91.56,8
M5M2E1,3,194,36,51,29.32,11,91.56,33
M5M2A9,4,194,37,88,29.32,11,91.56,34
M5M2E4,5,194,4,92,29.32,1,91.55,4
M5M2E2,6,194,5,97,29.32,1,91.54,5
M5M3P3,7,193,2,99,29.32,1,91.52,2
L3T3B7,8,191,4,103,26.83,1,99.89,4
L3T3S1,9,191,8,111,26.83,2,99.89,8
L3T3T9,10,191,7,118,26.83,2,99.88,7
L3T3T4,11,191,25,143,26.83,7,99.88,25
L3T3B6,12,191,21,164,26.83,6,99.88,21
L3T3T3,13,191,22,186,26.83,6,99.88,22
M5M3P4,14,191,9,195,28.87,3,90.81,8
M5M3N1,15,191,10,205,28.75,3,90.97,9
M5M3M9,16,190,12,217,28.58,3,90.80,11
M5M2S8,17,190,12,229,28.57,3,90.79,11
M5M3P6,18,186,1,230,27.65,0,89.86,1
M5M2T3,19,186,3,233,27.66,1,89.81,3
M5M2K4,20,186,10,243,27.65,3,89.83,9
M5M2T5,21,186,5,248,27.65,1,89.83,4
M5M3P9,22,186,5,253,27.65,1,89.83,4
M5M2L9,23,186,4,257,27.65,1,89.83,4
M5M3P8,24,186,6,263,27.65,2,89.83,5
M5M3R2,25,186,7,270,27.65,2,89.83,6
M5M2R3,26,186,3,273,27.65,1,89.83,3
M5M2M1,27,186,12,285,27.65,3,89.83,11
M5M2N6,28,186,12,297,27.65,3,89.82,11
M5M2S9,29,186,3,300,27.65,1,89.82,3
M5M2K2,30,186,7,307,27.65,2,89.82,6
M5M2J9,31,186,15,322,27.65,4,89.82,13
M5M2L8,32,186,7,329,27.65,2,89.81,6
M3A1P2,33,186,2,331,28.59,1,85.74,2
M5M2M2,34,186,9,340,27.65,2,89.81,8
M3A2K4,35,186,4,344,28.59,1,85.73,3
M3A2K6,36,186,9,353,28.59,3,85.72,8
M3A1P7,37,186,8,361,28.59,2,85.72,7
M3A1P6,38,186,19,380,28.59,5,85.72,16
M3A2L8,39,186,22,402,28.59,6,85.72,19
M3A1T4,40,186,24,426,28.59,7,85.71,21
M3A1R9,41,186,18,444,28.59,5,85.71,15
M3A1P5,42,186,9,453,28.59,3,85.71,8
M3A2M3,43,186,8,461,28.59,2,85.71,7
M3A2K3,44,186,4,465,28.59,1,85.71,3
M3A1S1,45,186,10,475,28.59,3,85.71,9
M3A2M9,46,186,1,476,28.59,0,85.69,1
M5M2K1,47,186,1,477,27.65,0,89.76,1
M5M3P7,48,186,1,478,27.65,0,89.76,1
M5M0A7,49,184,1,479,35.58,0,53.49,1
M4P2N3,50,184,3,482,28.13,1,85.68,3
M4P2K2,51,184,7,489,28.13,2,85.66,6
M4N1A5,52,184,26,515,28.13,7,85.66,22
M4P2B5,53,184,31,546,28.13,9,85.66,27
M4P2C2,54,184,25,571,28.13,7,85.65,21
M4P2B6,55,184,22,593,28.13,6,85.65,19
M4P2B9,56,184,37,630,28.13,10,85.65,32
M4P2C4,57,184,18,648,28.13,5,85.65,15
M4P2M7,58,184,4,652,28.13,1,85.64,3
M4P2M6,59,184,1,653,28.89,0,82.18,1
M4N2R2,60,183,7,660,24.75,2,100.00,7
M4N1K3,61,183,8,668,24.75,2,100.00,8
M4N1K4,62,183,9,677,24.75,2,100.00,9
M4N1J9,63,183,5,682,24.75,1,100.00,5
M4N1H2,64,183,8,690,24.75,2,100.00,8
M4N1K2,65,183,2,692,24.75,0,100.00,2
M4N1L7,66,183,4,696,24.75,1,100.00,4
M4N1H3,67,183,9,705,24.75,2,100.00,9
M4N2R3,68,183,7,712,24.75,2,100.00,7
M4N1E8,69,183,10,722,24.75,2,100.00,10
M4N1H4,70,183,7,729,24.75,2,100.00,7
M4N1K1,71,183,15,744,24.75,4,100.00,15
M4N2S7,72,183,2,746,24.75,0,100.00,2
M4N1H1,73,183,20,766,24.75,5,100.00,20
M4N1G2,74,183,9,775,24.75,2,100.00,9
M4N1L9,75,183,6,781,24.75,1,100.00,6
M4N1L4,76,183,8,789,24.75,2,100.00,8
M4N2T4,77,183,2,791,24.75,0,100.00,2
M4N2P6,78,183,3,794,24.74,1,100.00,3
M4N2S6,79,183,3,797,24.74,1,100.00,3
M4N2T3,80,183,3,800,24.74,1,100.00,3
M6C1Z3,81,182,1,801,27.65,0,85.55,1
M6C3J1,82,182,16,817,27.65,4,85.47,14
M6C3J2,83,182,20,837,27.65,6,85.47,17
M9C3V8,84,182,3,840,28.74,1,80.74,2
M6C3J6,85,182,18,858,27.65,5,85.47,15
M9C3V5,86,182,6,864,28.74,2,80.70,5
M9C4H2,87,182,16,880,28.74,5,80.70,13
M6C3G7,88,182,1,881,27.65,0,85.42,1
M6C1Z4,89,182,2,883,27.65,1,85.41,2
M6B0A7,90,181,8,891,28.81,2,80.07,6
M4G1Y6,91,181,3,894,29.21,1,78.07,2
M4G1S9,92,181,7,901,29.21,2,78.06,5
M4G3N3,93,181,9,910,29.21,3,78.06,7
M4G1Y7,94,181,5,915,29.21,1,78.06,4
M4G3H4,95,181,21,936,29.21,6,78.06,16
M4G1Z7,96,181,7,943,29.21,2,78.06,5
M4G3J9,97,181,4,947,29.21,1,78.06,3
M4G1Z9,98,181,8,955,29.21,2,78.06,6
M4G1S7,99,181,9,964,29.21,3,78.06,7
M4G3H3,100,181,6,970,29.21,2,78.06,5
M4G3N4,101,181,9,979,29.21,3,78.06,7
M4G3G6,102,181,23,1002,29.21,7,78.06,18
M4G3H5,103,181,11,1013,29.21,3,78.06,9
M4G3N5,104,181,8,1021,29.21,2,78.05,6
M4G3K1,105,181,17,1038,29.21,5,78.05,13
M4G2A7,106,181,10,1048,29.21,3,78.05,8
M4G1Y8,107,181,6,1054,29.21,2,78.05,5
M4G1V8,108,181,1,1055,29.21,0,78.03,1
M4G1Y4,109,181,2,1057,29.21,1,78.01,2
M4N3B5,110,181,5,1062,26.21,1,90.89,5
M4N2T9,111,181,1,1063,26.21,0,90.88,1
M4N1N4,112,181,10,1073,26.21,3,90.88,9
M4N1T3,113,181,4,1077,26.21,1,90.88,4
M4N1M3,114,181,18,1095,26.21,5,90.88,16
M4N1N8,115,181,16,1111,26.21,4,90.88,15
M4N1M2,116,181,7,1118,26.21,2,90.87,6
M4N1R2,117,181,12,1130,26.21,3,90.87,11
M4N1M4,118,181,6,1136,26.21,2,90.87,5
M4N1P6,119,181,12,1148,26.21,3,90.87,11
M4N1R3,120,181,18,1166,26.21,5,90.87,16
M4N1P7,121,181,18,1184,26.21,5,90.87,16
M4N3B6,122,181,14,1198,26.21,4,90.87,13
M4N1M1,123,181,6,1204,26.21,2,90.87,5
M4N1R4,124,181,2,1206,26.21,1,90.86,2
M4N3B7,125,181,4,1210,26.21,1,90.85,4
M3H1B8,126,181,2,1212,25.88,1,92.18,2
M3H1E5,127,181,5,1217,25.88,1,92.18,5
M3H1J5,128,181,3,1220,25.88,1,92.17,3
M3H1B6,129,181,5,1225,25.88,1,92.17,5
M3H1J7,130,181,10,1235,25.88,3,92.17,9
M3H1C9,131,181,6,1241,25.88,2,92.17,6
M3H1B7,132,181,3,1244,25.88,1,92.17,3
M3H1J8,133,181,12,1256,25.88,3,92.16,11
M3H1J6,134,181,4,1260,25.88,1,92.16,4
M3H1E3,135,181,27,1287,25.88,7,92.16,25
M3H1J9,136,181,15,1302,25.88,4,92.16,14
M3H1E1,137,181,8,1310,25.88,2,92.16,7
M3H1K3,138,181,11,1321,25.88,3,92.16,10
M3H1E2,139,181,10,1331,25.88,3,92.16,9
M3H1K1,140,181,13,1344,25.88,3,92.16,12
M3H1E4,141,181,3,1347,25.88,1,92.15,3
M9C2H2,142,181,1,1348,30.09,0,73.84,1
M9C2G8,143,181,1,1349,30.09,0,73.82,1
M4N3B3,144,181,7,1356,26.14,2,90.88,6
M4T1L3,145,180,2,1358,26.04,1,90.99,2
M4T1L2,146,180,3,1361,26.04,1,90.97,3
M5M0A4,147,180,1,1362,31.92,0,64.92,1
M5P3A6,148,180,1,1363,26.59,0,87.59,1
M5P3A4,149,180,1,1364,26.59,0,87.58,1
M5P1Z7,150,180,2,1366,26.59,1,87.58,2
M5P1Y3,151,180,3,1369,26.59,1,87.57,3
M5P1Y1,152,180,3,1372,26.59,1,87.57,3
M5P2X4,153,180,7,1379,26.59,2,87.57,6
M5P3B2,154,180,3,1382,26.59,1,87.57,3
M5P2R6,155,180,5,1387,26.59,1,87.57,4
M5P1X7,156,180,9,1396,26.59,2,87.56,8
M5P1W5,157,180,11,1407,26.59,3,87.56,10
M5P1X6,158,180,11,1418,26.59,3,87.56,10
M5P1X9,159,180,5,1423,26.59,1,87.56,4
M5P1Z1,160,180,6,1429,26.59,2,87.56,5
M5P2R5,161,180,10,1439,26.59,3,87.56,9
M5P3C6,162,180,11,1450,26.59,3,87.56,10
M5P3B1,163,180,7,1457,26.59,2,87.56,6
M5P3B4,164,180,8,1465,26.59,2,87.56,7
M5P1X8,165,180,11,1476,26.59,3,87.56,10
M5P3C8,166,180,5,1481,26.59,1,87.56,4
M5P3A3,167,180,15,1496,26.59,4,87.56,13
M5P3A5,168,180,6,1502,26.59,2,87.55,5
M5P1Y2,169,179,2,1504,26.59,1,87.54,2
M5P1W7,170,179,3,1507,26.59,1,87.54,3
M4T1G1,171,179,14,1521,26.52,4,87.54,12
M4T2L3,172,179,13,1534,26.52,3,87.54,11
M4T1J2,173,179,18,1552,26.52,5,87.53,16
M4G3K3,174,179,13,1565,28.24,4,80.08,10
M4T2K3,175,179,14,1579,26.52,4,87.53,12
M4T2H9,176,179,8,1587,26.52,2,87.53,7
M4T2K2,177,179,15,1602,26.52,4,87.53,13
M4T1J1,178,179,15,1617,26.52,4,87.53,13
M4T1L1,179,179,19,1636,26.52,5,87.53,17
M4T1P6,180,179,21,1657,26.52,6,87.53,18
M4T1J4,181,179,5,1662,26.52,1,87.53,4
M4T2H8,182,179,1,1663,26.52,0,87.51,1
M4G3J7,183,179,11,1674,28.16,3,80.38,9
M4G2A6,184,179,12,1686,28.18,3,80.19,10
M4G3N9,185,179,10,1696,28.11,3,80.35,8
M5M3L4,186,179,3,1699,27.48,1,83.07,2
M5M3L5,187,179,1,1700,27.48,0,83.05,1
M4G2E4,188,179,3,1703,28.10,1,80.34,2
M4G2A5,189,179,9,1712,28.10,3,80.34,7
M4G3N7,190,179,14,1726,28.10,4,80.34,11
M4G3K4,191,179,16,1742,28.10,4,80.34,13
M4G3N6,192,179,14,1756,28.10,4,80.33,11
M4G1P5,193,179,22,1778,28.10,6,80.33,18
M4G2E5,194,179,8,1786,28.10,2,80.33,6
M4G1P8,195,179,14,1800,28.10,4,80.33,11
M5N1R1,196,179,1,1801,27.62,0,82.39,1
M4G2A4,197,179,1,1802,28.10,0,80.25,1
M9C4H9,198,179,2,1804,27.98,1,80.75,2
M9C4C9,199,179,2,1806,27.98,1,80.73,2
M9C4S6,200,179,19,1825,27.98,5,80.71,15
M9C4H3,201,179,12,1837,27.98,3,80.71,10
M9C4H4,202,179,25,1862,27.98,7,80.71,20
M9C4C1,203,179,19,1881,27.98,5,80.70,15
M9C3V4,204,179,3,1884,27.98,1,80.69,2
M8X1P3,205,179,4,1888,28.26,1,79.26,3
M9C1M5,206,178,1,1889,29.45,0,73.82,1
M9C2T8,207,178,9,1898,29.45,3,73.79,7
M9C1M7,208,178,13,1911,29.45,4,73.79,10
M9C1N1,209,178,2,1913,29.45,1,73.77,1
M9C2T7,210,178,12,1925,29.44,4,73.79,9
M9C2G9,211,178,35,1960,29.44,10,73.79,26
M9C2H1,212,178,13,1973,29.44,4,73.78,10
M4G3M9,213,178,4,1977,27.88,1,80.40,3
M4G1S4,214,178,4,1981,27.88,1,80.39,3
M4G1V5,215,178,5,1986,27.88,1,80.39,4
M4G1V4,216,178,7,1993,27.88,2,80.39,6
M4G1N5,217,178,6,1999,27.88,2,80.38,5
M4G1M2,218,178,9,2008,27.88,3,80.38,7
M4G1N7,219,178,14,2022,27.88,4,80.38,11
M4G1N6,220,178,16,2038,27.88,4,80.38,13
M4G1S3,221,178,13,2051,27.88,4,80.38,10
M4G1W1,222,178,8,2059,27.88,2,80.38,6
M4G1M4,223,178,16,2075,27.88,4,80.38,13
M4G3J3,224,178,8,2083,27.88,2,80.38,6
M4G3N1,225,178,6,2089,27.88,2,80.38,5
M4G1H7,226,178,17,2106,27.88,5,80.38,14
M4G3J2,227,178,9,2115,27.88,3,80.38,7
M4G1M3,228,178,16,2131,27.88,4,80.38,13
M4G3J5,229,178,8,2139,27.88,2,80.37,6
M4G4H8,230,178,1,2140,27.88,0,80.36,1
M9C2H6,231,178,4,2144,29.31,1,73.80,3
M9C1N3,232,178,11,2155,29.31,3,73.79,8
M9A5G2,233,177,12,2167,28.89,3,75.22,9
M4N3R7,234,177,1,2168,25.95,0,87.90,1
L4H1X9,235,177,14,2182,34.00,5,52.79,7
M8Y4A5,236,177,1,2183,28.72,0,75.38,1
M9C1W6,237,177,3,2186,30.51,1,67.48,2
M9C1K9,238,177,17,2203,30.51,5,67.47,11
M9C1W8,239,177,5,2208,30.51,2,67.47,3
M5N1P9,240,177,1,2209,27.60,0,80.08,1
M5N1N9,241,177,2,2211,27.60,1,80.06,2
L4J0A3,242,176,6,2217,28.03,2,77.78,5
M4N3N4,243,176,7,2224,25.72,2,87.77,6
L4J6X8,244,176,10,2234,27.53,3,79.92,8
L4J6Z2,245,176,18,2252,27.53,5,79.92,14
L4J8A2,246,176,12,2264,27.53,3,79.92,10
L4J4V2,247,176,16,2280,27.53,4,79.92,13
L4J4V4,248,176,11,2291,27.53,3,79.92,9
L4J6X9,249,176,18,2309,27.53,5,79.92,14
M3B3C9,250,176,7,2316,26.14,2,85.91,6
M3B3G9,251,176,2,2318,26.14,1,85.91,2
M3B1T8,252,176,7,2325,26.14,2,85.91,6
M3B1T7,253,176,6,2331,26.14,2,85.91,5
M3B3E2,254,176,26,2357,26.14,7,85.91,22
M3B2J6,255,176,15,2372,26.14,4,85.91,13
M3B3C6,256,176,28,2400,26.14,7,85.91,24
M3B3B4,257,176,25,2425,26.14,7,85.91,21
M3B3B3,258,176,23,2448,26.14,6,85.91,20
M3B3E3,259,176,13,2461,26.14,3,85.90,11
M3B2H8,260,176,11,2472,26.14,3,85.90,9
M3B2J5,261,176,7,2479,26.14,2,85.90,6
M3B3H7,262,176,1,2480,26.14,0,85.87,1
M8X1P5,263,176,2,2482,27.64,1,79.30,2
M9B3B8,264,176,3,2485,28.20,1,76.86,2
M9B5W9,265,176,2,2487,28.20,1,76.86,2
M9B5X1,266,176,2,2489,28.20,1,76.86,2
M9B5J7,267,176,2,2491,28.20,1,76.85,2
M9B5Z1,268,176,7,2498,28.20,2,76.85,5
M9B2Z3,269,176,11,2509,28.20,3,76.85,8
M9B5X6,270,176,16,2525,28.20,5,76.85,12
M9B2Y9,271,176,8,2533,28.20,2,76.85,6
M9B3B6,272,176,23,2556,28.20,6,76.85,18
M9B3B9,273,176,7,2563,28.20,2,76.85,5
M9B3B4,274,176,26,2589,28.20,7,76.84,20
M9B5W8,275,176,12,2601,28.20,3,76.84,9
M8X1M6,276,176,3,2604,27.64,1,79.27,2
M9B3E8,277,176,3,2607,28.20,1,76.84,2
M9B3B5,278,176,17,2624,28.20,5,76.84,13
M8X2A4,279,176,3,2627,27.64,1,79.27,2
M9B5J8,280,176,15,2642,28.20,4,76.84,12
M8X1N7,281,176,6,2648,27.64,2,79.26,5
M8X1N3,282,176,5,2653,27.64,1,79.26,4
M9B5X2,283,176,5,2658,28.20,1,76.83,4
M8X2B4,284,176,6,2664,27.64,2,79.26,5
M8X1N5,285,176,6,2670,27.64,2,79.26,5
M8X2A6,286,176,12,2682,27.64,3,79.26,10
M8X1N8,287,176,5,2687,27.64,1,79.26,4
M8X2G7,288,176,17,2704,27.64,5,79.25,13
M8X2B1,289,176,15,2719,27.64,4,79.25,12
M9B5W7,290,176,2,2721,28.20,1,76.83,2
M8X2C6,291,176,18,2739,27.64,5,79.25,14
M8X2C9,292,176,13,2752,27.64,4,79.25,10
M8X2A8,293,176,3,2755,27.64,1,79.25,2
M8X2E3,294,176,18,2773,27.64,5,79.25,14
M9B3E6,295,176,2,2775,28.20,1,76.82,2
M8X2B2,296,176,14,2789,27.64,4,79.25,11
M8X2E4,297,176,17,2806,27.64,5,79.25,13
M8X2B3,298,176,11,2817,27.64,3,79.24,9
M8X2C8,299,176,17,2834,27.64,5,79.24,13
M8X1M8,300,176,7,2841,27.64,2,79.24,6
M8X2A2,301,176,3,2844,27.64,1,79.21,2
M4T1K9,302,176,20,2864,25.65,5,87.53,18
M5M2S7,303,176,13,2877,26.50,3,83.69,11
M4T2L5,304,176,1,2878,24.80,0,90.99,1
M4T2H4,305,176,1,2879,24.80,0,90.99,1
M4T1L5,306,176,2,2881,24.80,0,90.98,2
M4T2L4,307,176,4,2885,24.80,1,90.97,4
M4T2L1,308,176,4,2889,24.80,1,90.97,4
M4T1J3,309,176,5,2894,24.80,1,90.96,5
M4T2K4,310,176,10,2904,24.80,2,90.96,9
M4T2J8,311,176,8,2912,24.80,2,90.96,7
M4T1G2,312,176,14,2926,24.80,3,90.96,13
M4T1C8,313,176,7,2933,24.80,2,90.96,6
M4T1P7,314,176,7,2940,24.80,2,90.96,6
M4T1C7,315,176,40,2980,24.80,10,90.96,36
M4T1E1,316,176,7,2987,24.80,2,90.95,6
M4T1J7,317,176,8,2995,24.80,2,90.95,7
M4T2L2,318,176,3,2998,24.80,1,90.95,3
M4T2K9,319,176,7,3005,24.80,2,90.95,6
M4T2K1,320,176,7,3012,24.80,2,90.95,6
M4T1J6,321,176,8,3020,24.80,2,90.95,7
M4T1A7,322,176,9,3029,24.80,2,90.95,8
M4T1J5,323,176,7,3036,24.80,2,90.95,6
M4T2J9,324,176,8,3044,24.80,2,90.95,7
M4T1C9,325,176,7,3051,24.80,2,90.94,6
M4T1L4,326,176,2,3053,24.80,0,90.93,2
M9C2J3,327,176,11,3064,29.18,3,71.93,8
M9C2T2,328,176,7,3071,29.18,2,71.93,5
M9C2T1,329,176,18,3089,29.18,5,71.92,13
M9C2T3,330,176,8,3097,29.18,2,71.92,6
M8Y4E7,331,176,1,3098,28.37,0,75.42,1
M9C2H5,332,176,2,3100,29.18,1,71.89,1
M9C2T5,333,176,1,3101,29.18,0,71.89,1
M4T2H6,334,176,1,3102,24.79,0,90.90,1
M9A3M7,335,176,3,3105,27.18,1,80.48,2
M9A3M8,336,176,3,3108,27.18,1,80.47,2
M8X2T9,337,175,12,3120,28.39,3,75.11,9
M8X2T6,338,175,9,3129,28.39,3,75.11,7
M5M0A3,339,175,8,3137,30.70,2,65.07,5
M5M3L3,340,175,4,3141,26.39,1,83.46,3
M9A3M1,341,175,1,3142,27.97,0,76.44,1
M9A2Z5,342,175,3,3145,27.97,1,76.39,2
M9A3S3,343,175,6,3151,27.97,2,76.39,5
M9A3X5,344,175,3,3154,27.97,1,76.39,2
M9A2Y4,345,175,3,3157,27.97,1,76.39,2
M9A2X5,346,175,11,3168,27.97,3,76.39,8
M9A2Z1,347,175,4,3172,27.97,1,76.38,3
M9A3R3,348,175,8,3180,27.97,2,76.38,6
M9A3R1,349,175,15,3195,27.97,4,76.38,11
M9A3B9,350,175,3,3198,27.97,1,76.38,2
M9A2Z4,351,175,10,3208,27.97,3,76.38,8
M9A2Y6,352,175,10,3218,27.97,3,76.38,8
M9A3S4,353,175,34,3252,27.97,10,76.38,26
M9A2X2,354,175,2,3254,27.97,1,76.38,2
M9A3A4,355,175,28,3282,27.97,8,76.38,21
M9A2Y2,356,175,10,3292,27.97,3,76.37,8
M9A3S1,357,175,13,3305,27.97,4,76.37,10
M5M3R9,358,175,1,3306,28.26,0,75.11,1
M9A3S5,359,175,2,3308,27.97,1,76.37,2
M9A3T4,360,175,3,3311,27.97,1,76.37,2
M9A3B7,361,175,2,3313,27.97,1,76.37,2
M5M2Y9,362,175,2,3315,28.26,1,75.10,2
M9A3S2,363,175,2,3317,27.97,1,76.35,2
M5M2R4,364,175,2,3319,28.26,1,75.09,2
M5M3R6,365,175,1,3320,28.26,0,75.09,1
M5M3S3,366,175,5,3325,28.26,1,75.08,4
M5M3S2,367,175,6,3331,28.26,2,75.08,5
M5M2R5,368,175,3,3334,28.26,1,75.07,2
M5M2X8,369,175,9,3343,28.26,3,75.07,7
M5M2X7,370,175,9,3352,28.26,3,75.07,7
M5M2T6,371,175,12,3364,28.26,3,75.07,9
M5M2N7,372,175,10,3374,28.26,3,75.07,8
M5M2T7,373,175,10,3384,28.26,3,75.07,8
M5M3H6,374,175,6,3390,28.26,2,75.07,5
M5M3L9,375,175,16,3406,28.26,5,75.07,12
M5M4M5,376,175,1,3407,28.26,0,75.06,1
M5M3R5,377,175,5,3412,28.26,1,75.06,4
M5M3H4,378,175,5,3417,28.26,1,75.06,4
M5M3S1,379,175,11,3428,28.26,3,75.06,8
M5M3L8,380,175,16,3444,28.26,5,75.06,12
M5M2Z1,381,175,3,3447,28.26,1,75.06,2
M5M3H7,382,175,1,3448,28.26,0,75.03,1
L4J4S1,383,175,18,3466,27.62,5,77.78,14
L4J4S2,384,175,18,3484,27.62,5,77.78,14
L4J4S4,385,175,19,3503,27.62,5,77.78,15
L4J4S6,386,175,8,3511,27.62,2,77.78,6
L4J4R9,387,175,9,3520,27.62,2,77.78,7
L4J4S5,388,175,14,3534,27.62,4,77.78,11
L4J4R4,389,175,10,3544,27.62,3,77.78,8
L4J4S3,390,175,10,3554,27.62,3,77.78,8
L4J4R7,391,175,10,3564,27.62,3,77.77,8
L4J4R1,392,175,10,3574,27.62,3,77.77,8
M6C1Z5,393,175,3,3577,27.40,1,78.59,2
M6C3J5,394,175,18,3595,27.40,5,78.57,14
M6C3J7,395,175,2,3597,26.91,1,80.66,2
M6C3K3,396,175,4,3601,26.91,1,80.65,3
M6C3H6,397,175,5,3606,26.91,1,80.65,4
M6C2H5,398,175,14,3620,26.91,4,80.65,11
M6C2G5,399,175,16,3636,26.91,4,80.65,13
M6C3H5,400,175,5,3641,26.91,1,80.65,4
M6C2G6,401,175,12,3653,26.91,3,80.65,10
M6C2H3,402,175,9,3662,26.91,2,80.65,7
M6C2H4,403,175,15,3677,26.91,4,80.65,12
M6C2G4,404,175,8,3685,26.91,2,80.65,6
M6C2J7,405,175,16,3701,26.91,4,80.65,13
M6C3J9,406,175,7,3708,26.91,2,80.65,6
M6C3J8,407,175,5,3713,26.91,1,80.65,4
M6C2H2,408,175,9,3722,26.91,2,80.65,7
M6C2G3,409,175,7,3729,26.91,2,80.65,6
M6C3K1,410,175,6,3735,26.91,2,80.65,5
M6C2J5,411,175,9,3744,26.91,2,80.64,7
M6C2J8,412,175,16,3760,26.91,4,80.64,13
M6C2K4,413,175,13,3773,26.91,3,80.64,10
M6C3K2,414,175,7,3780,26.91,2,80.64,6
M6C3K4,415,175,5,3785,26.91,1,80.64,4
M4G2J5,416,175,13,3798,28.09,4,75.47,10
M8Y4G1,417,175,1,3799,28.09,0,75.47,1
M8Y2B7,418,175,4,3803,28.09,1,75.42,3
M8Y4C9,419,175,1,3804,28.09,0,75.42,1
M8Y4B1,420,175,4,3808,28.09,1,75.41,3
M8Y2B2,421,175,3,3811,28.09,1,75.41,2
M8Y2L4,422,175,9,3820,28.09,3,75.41,7
M8Y2C1,423,175,4,3824,28.09,1,75.41,3
M8Y2B5,424,175,3,3827,28.09,1,75.41,2
M8Y4A7,425,175,10,3837,28.09,3,75.41,8
M8Y2B4,426,175,3,3840,28.09,1,75.40,2
M8Y2A5,427,175,9,3849,28.09,3,75.40,7
M8Y2A4,428,175,12,3861,28.09,3,75.40,9
M8Y3K7,429,175,1,3862,28.09,0,75.40,1
M8Y2K3,430,175,9,3871,28.09,3,75.40,7
M8Y2G8,431,175,13,3884,28.09,4,75.40,10
M8Y2K5,432,175,14,3898,28.09,4,75.40,11
M8Y2L5,433,175,14,3912,28.09,4,75.40,11
M8Y2B9,434,175,6,3918,28.09,2,75.40,5
M8Y2H1,435,175,5,3923,28.09,1,75.40,4
M8Y2K4,436,175,8,3931,28.09,2,75.40,6
M8Y3K6,437,175,2,3933,28.09,1,75.40,2
M8Y2B8,438,175,10,3943,28.09,3,75.40,8
M8Y2K6,439,175,15,3958,28.09,4,75.40,11
M8Y4C8,440,174,3,3961,28.09,1,75.39,2
M8Y2A6,441,174,1,3962,28.09,0,75.39,1
M8Y2B6,442,174,6,3968,28.09,2,75.39,5
M8Y4E8,443,174,2,3970,28.09,1,75.39,2
M8Y4E9,444,174,5,3975,28.09,1,75.39,4
M5N1Y1,445,174,2,3977,27.47,1,78.07,2
M8Y4C7,446,174,2,3979,28.09,1,75.38,2
M8Y2B3,447,174,3,3982,28.09,1,75.38,2
M2J1A5,448,174,12,3994,28.62,3,73.07,9
M2J1B6,449,174,10,4004,28.62,3,73.07,7
M2J1B4,450,174,7,4011,28.62,2,73.06,5
M2J1C4,451,174,11,4022,28.62,3,73.06,8
M2J1E3,452,174,10,4032,28.62,3,73.06,7
M2J1A4,453,174,9,4041,28.62,3,73.06,7
M2J1H5,454,174,16,4057,28.62,5,73.06,12
M2J1C5,455,174,20,4077,28.62,6,73.06,15
M2J1E4,456,174,10,4087,28.62,3,73.06,7
M2J1B5,457,174,27,4114,28.62,8,73.06,20
M2J1E1,458,174,5,4119,28.62,1,73.06,4
M2J1A6,459,174,6,4125,28.62,2,73.05,4
L4L1T7,460,174,4,4129,33.28,1,52.79,2
M5N1T1,461,174,18,4147,26.44,5,82.39,15
M5N1W4,462,174,21,4168,26.44,6,82.38,17
M5N1R8,463,174,17,4185,26.44,4,82.38,14
M5N1N8,464,174,24,4209,26.44,6,82.38,20
M5N1V2,465,174,20,4229,26.44,5,82.38,16
M5N1P8,466,174,19,4248,26.44,5,82.38,16
M5N1P7,467,174,17,4265,26.44,4,82.38,14
M5N1S9,468,174,19,4284,26.44,5,82.38,16
M5N1V1,469,174,20,4304,26.44,5,82.38,16
M5N1R9,470,174,19,4323,26.44,5,82.38,16
M5N2R4,471,174,5,4328,26.44,1,82.38,4
M5N2R2,472,174,2,4330,26.44,1,82.38,2
M9C1X1,473,174,13,4343,29.86,4,67.48,9
M9C1S4,474,174,12,4355,29.86,4,67.48,8
M9C1S2,475,174,2,4357,29.86,1,67.44,1
M9C1W9,476,174,7,4364,29.83,2,67.49,5
M9C1W7,477,174,3,4367,29.83,1,67.46,2
M5N2H6,478,174,2,4369,27.38,1,78.07,2
M5N1W3,479,174,13,4382,27.38,4,78.07,10
M5N1X8,480,174,17,4399,27.38,5,78.06,13
M5N2R7,481,174,4,4403,27.38,1,78.06,3
M5N1X5,482,174,10,4413,27.38,3,78.06,8
M5N1X7,483,174,27,4440,27.38,7,78.06,21
M5N1X6,484,174,9,4449,27.38,2,78.06,7
M5N1W2,485,174,15,4464,27.38,4,78.06,12
M5N2H4,486,174,16,4480,27.38,4,78.06,12
M5N1T9,487,174,18,4498,27.38,5,78.06,14
M5N1W5,488,174,21,4519,27.38,6,78.06,16
M5N2X5,489,174,1,4520,27.38,0,78.06,1
M5N2X6,490,174,8,4528,27.38,2,78.06,6
M5N2X7,491,174,10,4538,27.38,3,78.06,8
M5N1X9,492,174,17,4555,27.38,5,78.06,13
M5N2R6,493,174,8,4563,27.38,2,78.06,6
M5N2R5,494,174,3,4566,27.38,1,78.05,2
M9C1S3,495,174,2,4568,29.83,1,67.44,1
M5N1Y2,496,174,2,4570,27.38,1,78.05,2
M5M2X6,497,174,3,4573,26.19,1,83.07,2
M5M3G8,498,174,6,4579,26.19,2,83.06,5
M5M2J6,499,174,8,4587,26.19,2,83.05,7
M5M2J7,500,174,6,4593,26.19,2,83.04,5
M5M3C9,501,174,6,4599,26.19,2,83.04,5
M5M2J5,502,174,18,4617,26.19,5,83.04,15
M5M3E5,503,174,8,4625,26.19,2,83.04,7
M5M2J8,504,174,4,4629,26.19,1,83.04,3
M5M4M6,505,174,14,4643,26.19,4,83.04,12
M5M3E4,506,174,10,4653,26.19,3,83.04,8
M5M2W4,507,174,23,4676,26.19,6,83.04,19
M5M3C6,508,174,22,4698,26.19,6,83.04,18
M5M3C7,509,174,11,4709,26.19,3,83.04,9
M4N1M8,510,174,1,4710,27.22,0,78.57,1
M5M3G9,511,174,4,4714,26.19,1,83.03,3
M5M2T2,512,174,7,4721,26.18,2,83.03,6
M5M2T1,513,174,3,4724,26.18,1,83.02,2
M4N1S5,514,174,10,4734,27.22,3,78.51,8
M4N2T7,515,174,5,4739,27.22,1,78.51,4
M4N2T8,516,174,5,4744,27.22,1,78.51,4
M4N2R4,517,174,6,4750,27.22,2,78.51,5
M4N1N1,518,174,8,4758,27.22,2,78.51,6
M4N2P7,519,174,4,4762,27.22,1,78.51,3
M4N1L6,520,174,9,4771,27.22,2,78.51,7
M4N1L8,521,174,17,4788,27.22,5,78.51,13
M4N2P8,522,174,10,4798,27.22,3,78.51,8
M4N1N5,523,174,5,4803,27.22,1,78.51,4
M4N1N3,524,174,17,4820,27.22,5,78.50,13
M4N1N6,525,174,8,4828,27.22,2,78.50,6
M4N1N2,526,174,9,4837,27.22,2,78.50,7
M4N2R5,527,174,4,4841,27.22,1,78.50,3
M4N2R7,528,174,8,4849,27.22,2,78.50,6
M4N1M7,529,174,3,4852,27.22,1,78.50,2
M4N1M9,530,174,6,4858,27.22,2,78.50,5
M4N1L5,531,174,1,4859,27.22,0,78.50,1
M4N1M5,532,174,2,4861,27.22,1,78.50,2
M4N2T6,533,174,2,4863,27.22,1,78.48,2
M4N1M6,534,174,1,4864,27.22,0,78.47,1
M4N2T5,535,174,1,4865,27.22,0,78.47,1
M9A2X3,536,174,2,4867,27.69,1,76.41,2
M9A3L6,537,174,2,4869,27.69,1,76.41,2
M9A3A2,538,174,3,4872,27.69,1,76.40,2
M9A3B1,539,174,13,4885,27.69,4,76.38,10
M9A2Z3,540,174,2,4887,27.69,1,76.38,2
M9A3X4,541,174,3,4890,27.69,1,76.38,2
M9A2Z7,542,174,14,4904,27.69,4,76.38,11
M9A2Y8,543,174,8,4912,27.69,2,76.38,6
M9A2Z6,544,174,3,4915,27.69,1,76.38,2
M9A2Z9,545,174,7,4922,27.69,2,76.38,5
M9A3X3,546,174,7,4929,27.69,2,76.38,5
M9A3S6,547,174,24,4953,27.69,7,76.38,18
M9A3X1,548,174,24,4977,27.69,7,76.38,18
M9A3A1,549,174,2,4979,27.69,1,76.38,2
M9A2Z8,550,174,8,4987,27.69,2,76.38,6
M9A3R2,551,174,21,5008,27.69,6,76.38,16
M9A3X6,552,174,9,5017,27.69,2,76.37,7
M9A3L4,553,174,7,5024,27.69,2,76.37,5
M9A3K8,554,174,14,5038,27.69,4,76.37,11
M9A3L9,555,174,1,5039,27.69,0,76.36,1
M9A3X2,556,174,2,5041,27.69,1,76.35,2
M9A2K5,557,174,1,5042,26.54,0,81.33,1
M9A2X6,558,174,1,5043,27.69,0,76.33,1
M9A3A3,559,174,2,5045,27.69,1,76.31,2
M9A1M7,560,174,1,5046,26.54,0,81.26,1
M9A3K9,561,174,4,5050,26.54,1,81.26,3
M9A1R2,562,174,2,5052,26.54,1,81.25,2
M5M3E3,563,174,6,5058,26.36,2,82.03,5
M9A3L2,564,174,1,5059,26.54,0,81.24,1
M9A1P8,565,174,1,5060,26.54,0,81.24,1
M9A2L2,566,174,4,5064,26.54,1,81.24,3
M4W3X6,567,174,4,5068,27.55,1,76.86,3
M9A1L8,568,174,6,5074,26.54,2,81.24,5
M9A1M5,569,174,8,5082,26.54,2,81.24,6
M9A2L3,570,174,5,5087,26.54,1,81.23,4
M9A1R1,571,174,2,5089,26.54,1,81.23,2
M9A2J7,572,174,6,5095,26.54,2,81.23,5
M9A1P3,573,174,7,5102,26.54,2,81.23,6
M9A1N1,574,174,4,5106,26.54,1,81.23,3
M9A1L6,575,174,14,5120,26.54,4,81.23,11
M9A1K5,576,174,14,5134,26.54,4,81.22,11
M9A1K4,577,174,6,5140,26.54,2,81.22,5
M9A3L1,578,174,4,5144,26.54,1,81.22,3
M9A1L7,579,174,7,5151,26.54,2,81.22,6
M9A2L4,580,174,9,5160,26.54,2,81.22,7
M9A2K4,581,174,3,5163,26.54,1,81.22,2
M9A2L7,582,174,8,5171,26.54,2,81.22,6
M9A1P2,583,174,12,5183,26.54,3,81.22,10
M9A1K9,584,174,2,5185,26.54,1,81.22,2
M9A2L5,585,174,8,5193,26.54,2,81.22,6
M9A3L3,586,174,3,5196,26.54,1,81.22,2
M9A1M8,587,174,2,5198,26.54,1,81.22,2
M4N1S9,588,174,14,5212,24.31,3,90.88,13
M9A1M9,589,174,6,5218,26.54,2,81.21,5
M9A2L6,590,174,6,5224,26.54,2,81.21,5
M9A1M6,591,174,4,5228,26.54,1,81.21,3
M9A2K1,592,174,2,5230,26.54,1,81.20,2
M9A1R3,593,174,2,5232,26.54,1,81.20,2
M9A1L1,594,174,2,5234,26.54,1,81.20,2
M4G1L5,595,174,2,5236,28.90,1,70.94,1
M8X2V2,596,174,5,5241,27.58,1,76.63,4
M8X2V7,597,174,12,5253,27.58,3,76.62,9
M8X2V5,598,174,5,5258,27.58,1,76.62,4
M8X2S9,599,174,15,5273,27.58,4,76.62,11
M8X2V4,600,174,6,5279,27.58,2,76.61,5
M4W3X7,601,174,14,5293,27.51,4,76.87,11
M5N1N6,602,174,22,5315,28.80,6,71.23,16
M5N1N7,603,174,28,5343,28.80,8,71.23,20
M5N1N5,604,174,23,5366,28.80,7,71.22,16
M5N2G1,605,174,14,5380,28.80,4,71.22,10
M5N1M7,606,174,30,5410,28.80,9,71.22,21
M5N2G4,607,174,16,5426,28.80,5,71.22,11
M5N1P6,608,174,24,5450,28.80,7,71.22,17
M9A2S2,609,173,2,5452,27.26,1,77.78,2
M9A2T3,610,173,2,5454,27.26,1,77.76,2
M9A2A7,611,173,6,5460,27.26,2,77.75,5
M9A1Z5,612,173,11,5471,27.26,3,77.75,9
M9A2B9,613,173,24,5495,27.26,7,77.75,19
M9A2S1,614,173,12,5507,27.26,3,77.75,9
M9A1Y1,615,173,8,5515,27.26,2,77.74,6
M9A2A9,616,173,22,5537,27.26,6,77.74,17
M9A1Z4,617,173,13,5550,27.26,4,77.74,10
M9A1Z6,618,173,6,5556,27.26,2,77.74,5
M9A2A8,619,173,28,5584,27.26,8,77.74,22
M9A2B1,620,173,13,5597,27.26,4,77.74,10
M9A2C1,621,173,12,5609,27.26,3,77.74,9
M9A2B4,622,173,7,5616,27.26,2,77.74,5
M9A2S9,623,173,8,5624,27.26,2,77.74,6
M9A2B2,624,173,9,5633,27.26,2,77.74,7
M9A2P8,625,173,3,5636,27.26,1,77.73,2
M9A2P9,626,173,2,5638,27.26,1,77.73,2
M9A1X8,627,173,6,5644,27.26,2,77.73,5
M9A2A6,628,173,7,5651,27.26,2,77.73,5
M9A2S5,629,173,2,5653,27.26,1,77.73,2
M9A2S7,630,173,1,5654,27.26,0,77.73,1
M9A2S4,631,173,2,5656,27.26,1,77.73,2
M9A2S3,632,173,2,5658,27.26,1,77.72,2
M9A3J5,633,173,2,5660,26.57,1,80.52,2
M9A4L1,634,173,1,5661,26.57,0,80.49,1
M9A4Z6,635,173,14,5675,26.57,4,80.49,11
M9A3J7,636,173,12,5687,26.57,3,80.48,10
M9A3Z9,637,173,8,5695,26.57,2,80.48,6
M9A4A4,638,173,21,5716,26.57,6,80.48,17
M9A3E9,639,173,12,5728,26.57,3,80.47,10
M9A3J6,640,173,31,5759,26.57,8,80.47,25
M9A3Z4,641,173,3,5762,26.57,1,80.46,2
M9A3J2,642,173,5,5767,26.57,1,80.46,4
M9A3Z3,643,173,2,5769,26.57,1,80.45,2
M5M3H1,644,173,6,5775,26.20,2,82.04,5
M5M2B1,645,173,41,5816,28.11,12,73.76,30
M9A3J8,646,173,2,5818,26.57,1,80.43,2
M5M3L7,647,173,2,5820,26.20,1,82.04,2
M5M3E1,648,173,11,5831,26.20,3,82.04,9
M5M3L6,649,173,8,5839,26.20,2,82.04,7
M5M3E7,650,173,16,5855,26.20,4,82.03,13
M5M3E8,651,173,12,5867,26.20,3,82.03,10
M5M3E9,652,173,11,5878,26.20,3,82.03,9
M5M3H2,653,173,12,5890,26.20,3,82.03,10
M5M3C8,654,173,13,5903,26.20,3,82.03,11
M5M3E6,655,173,17,5920,26.20,4,82.03,14
M5M3H3,656,173,14,5934,26.20,4,82.03,11
M5M2T4,657,173,13,5947,26.19,3,82.04,11
L4J1Z9,658,173,10,5957,28.44,3,72.25,7
L4J1Z8,659,173,8,5965,28.44,2,72.25,6
M5N2L6,660,173,6,5971,26.91,2,78.83,5
M5N1R2,661,173,10,5981,26.42,3,80.89,8
M4T2H1,662,173,1,5982,24.47,0,89.34,1
M4T2G8,663,173,1,5983,24.47,0,89.33,1
M4T1E7,664,173,9,5992,24.47,2,89.31,8
M4T1B8,665,173,14,6006,24.47,3,89.31,13
M4T1C3,666,173,9,6015,24.47,2,89.30,8
M4T2E4,667,173,5,6020,24.47,1,89.30,4
M4T1H9,668,173,10,6030,24.47,2,89.30,9
M4T1H7,669,173,9,6039,24.47,2,89.30,8
M4T1E8,670,173,11,6050,24.47,3,89.30,10
M4T2G9,671,173,1,6051,24.46,0,89.34,1
M4G1W2,672,173,10,6061,27.06,3,78.06,8
M4T2E5,673,173,3,6064,24.46,1,89.31,3
M3H1L8,674,173,5,6069,27.46,1,76.30,4
M4T1E9,675,173,11,6080,24.46,3,89.30,10
M4T1C5,676,173,12,6092,24.46,3,89.30,11
M4T1B6,677,173,35,6127,24.46,9,89.30,31
M4T1B7,678,173,13,6140,24.46,3,89.30,12
M3H1C5,679,173,9,6149,27.46,2,76.30,7
M4T1C4,680,173,13,6162,24.46,3,89.30,12
M3H1L7,681,173,14,6176,27.46,4,76.30,11
M3H1K8,682,173,8,6184,27.46,2,76.30,6
M3H1M1,683,173,15,6199,27.46,4,76.30,11
M4T2H7,684,173,1,6200,24.47,0,89.25,1
M3H1N5,685,173,12,6212,27.46,3,76.30,9
M3H1L9,686,173,15,6227,27.46,4,76.30,11
M3H1C1,687,173,13,6240,27.46,4,76.30,10
M3H1A2,688,173,9,6249,27.46,2,76.29,7
M4T1C2,689,173,9,6258,24.46,2,89.29,8
M3H1P1,690,173,18,6276,27.46,5,76.29,14
M3H1A7,691,173,3,6279,27.46,1,76.29,2
M3H1A6,692,173,9,6288,27.46,2,76.29,7
M3H1K9,693,173,5,6293,27.46,1,76.29,4
M3H1L2,694,173,5,6298,27.46,1,76.29,4
M3H1L1,695,173,5,6303,27.46,1,76.28,4
M4T1B5,696,173,1,6304,24.46,0,89.28,1
M4T2H5,697,173,1,6305,24.46,0,89.27,1
M4T2G7,698,173,1,6306,24.46,0,89.27,1
M5N1S2,699,173,1,6307,26.42,0,80.64,1
M9A4Z8,700,173,15,6322,26.63,4,79.71,12
M8X2T7,701,173,6,6328,28.62,2,71.07,4
M8X2T5,702,173,7,6335,28.62,2,71.07,5
M9A1H7,703,173,4,6339,29.08,1,69.07,3
M9A1H4,704,173,7,6346,29.08,2,69.07,5
M9B3M3,705,173,8,6354,29.08,2,69.07,6
M9A1G4,706,173,8,6362,29.08,2,69.06,6
M9A2G6,707,173,3,6365,29.08,1,69.06,2
M9A2G3,708,173,5,6370,29.08,1,69.06,3
M9A1H6,709,173,12,6382,29.08,3,69.06,8
M9A1E6,710,173,6,6388,29.08,2,69.06,4
M9A1H5,711,173,11,6399,29.08,3,69.05,8
M9A1H3,712,173,4,6403,29.08,1,69.05,3
M9B3M1,713,173,5,6408,29.08,1,69.05,3
M9A1H8,714,173,32,6440,29.08,9,69.05,22
M9A1H9,715,173,16,6456,29.08,5,69.05,11
M9A2G4,716,173,8,6464,29.08,2,69.05,6
M9A1G3,717,173,8,6472,29.08,2,69.05,6
M9A1E2,718,173,8,6480,29.08,2,69.05,6
M9A1J1,719,173,10,6490,29.08,3,69.05,7
M9A1G2,720,173,8,6498,29.08,2,69.05,6
M9A1E8,721,173,10,6508,29.08,3,69.05,7
M9A1G1,722,173,6,6514,29.08,2,69.04,4
M9B3L8,723,173,6,6520,29.08,2,69.04,4
M9A1E9,724,173,6,6526,29.08,2,69.04,4
M9A2G5,725,173,11,6537,29.08,3,69.04,8
M9A3N1,726,173,1,6538,26.60,0,79.77,1
M5N1M9,727,173,48,6586,27.75,13,74.75,36
M5N1S1,728,173,1,6587,26.42,0,80.52,1
M5N1R3,729,173,9,6596,26.42,2,80.49,7
M9A4Z7,730,173,25,6621,26.52,7,80.04,20
M5N1P2,731,173,11,6632,26.31,3,80.90,9
M6C1Z1,732,173,14,6646,27.32,4,76.52,11
M4G1G7,733,173,6,6652,28.61,2,70.90,4
M4G1H4,734,173,8,6660,28.61,2,70.89,6
M4G1H5,735,173,5,6665,28.61,1,70.89,4
M4G3M5,736,173,5,6670,28.61,1,70.89,4
M4G3M6,737,173,19,6689,28.61,5,70.88,13
M4G1H6,738,173,19,6708,28.61,5,70.88,13
M4G3M2,739,172,22,6730,28.61,6,70.88,16
M4G1G3,740,172,15,6745,28.61,4,70.88,11
M4G1G5,741,172,18,6763,28.61,5,70.88,13
M4G3L8,742,172,17,6780,28.61,5,70.88,12
M4G3M1,743,172,16,6796,28.61,5,70.88,11
M4G3R6,744,172,14,6810,28.61,4,70.87,10
M3C3T5,745,172,1,6811,25.75,0,83.25,1
M4T1V4,746,172,4,6815,26.65,1,79.34,3
M4T2C6,747,172,1,6816,26.65,0,79.33,1
M3C2M7,748,172,1,6817,25.75,0,83.23,1
M4T1V5,749,172,9,6826,26.65,2,79.33,7
M4T1S7,750,172,4,6830,26.65,1,79.33,3
M3C2P7,751,172,2,6832,25.75,1,83.22,2
M4T1G7,752,172,20,6852,26.65,5,79.32,16
M3H1A5,753,172,1,6853,27.33,0,76.37,1
M4T1T1,754,172,5,6858,26.65,1,79.31,4
M4T2E3,755,172,12,6870,26.65,3,79.31,10
M4T1S8,756,172,9,6879,26.65,2,79.31,7
M4T1S6,757,172,19,6898,26.65,5,79.31,15
M4T2G3,758,172,6,6904,26.65,2,79.31,5
M4T1G9,759,172,8,6912,26.65,2,79.31,6
M4T2G6,760,172,12,6924,26.65,3,79.31,10
M4T2E2,761,172,20,6944,26.65,5,79.31,16
M4T1R4,762,172,7,6951,26.65,2,79.31,6
M4T2G4,763,172,2,6953,26.65,1,79.31,2
M3C2M9,764,172,4,6957,25.75,1,83.20,3
M3C2L9,765,172,8,6965,25.75,2,83.19,7
M3C2P5,766,172,7,6972,25.75,2,83.19,6
M3C2N9,767,172,5,6977,25.75,1,83.19,4
M3C2L6,768,172,13,6990,25.75,3,83.19,11
M3C2N8,769,172,5,6995,25.75,1,83.19,4
M3C2L3,770,172,11,7006,25.75,3,83.19,9
M3C2L1,771,172,24,7030,25.75,6,83.19,20
M3C2P2,772,172,5,7035,25.75,1,83.18,4
M3C2M6,773,172,9,7044,25.75,2,83.18,7
M3C2P9,774,172,10,7054,25.75,3,83.18,8
M3C2N2,775,172,8,7062,25.75,2,83.18,7
M3C2L8,776,172,2,7064,25.75,1,83.18,2
M3C2L7,777,172,2,7066,25.75,1,83.18,2
M3C2N7,778,172,2,7068,25.75,1,83.18,2
M4T1R1,779,172,20,7088,26.64,5,79.31,16
M4N1X8,780,172,7,7095,28.50,2,71.25,5
M4N3C3,781,172,6,7101,28.50,2,71.23,4
M3H1N4,782,172,12,7113,27.33,3,76.30,9
M3H1N8,783,172,11,7124,27.33,3,76.30,8
M3C2N1,784,172,1,7125,25.75,0,83.12,1
M9A2Z2,785,172,1,7126,27.31,0,76.36,1
M3C2M8,786,172,1,7127,25.75,0,83.10,1
M3C2N6,787,172,1,7128,25.75,0,83.10,1
M4N3C1,788,172,1,7129,24.68,0,87.73,1
M5N2H5,789,172,2,7131,26.69,1,79.02,2
M5N1T6,790,172,4,7135,26.44,1,80.09,3
M4N2Z4,791,172,6,7141,27.31,2,76.32,5
M4N1W6,792,172,9,7150,27.31,2,76.32,7
M4N2Z1,793,172,11,7161,27.31,3,76.32,8
M4N2B4,794,172,32,7193,27.31,9,76.32,24
M4N3C8,795,172,8,7201,27.31,2,76.32,6
M4N1Z6,796,172,33,7234,27.31,9,76.32,25
M4N1Z5,797,172,42,7276,27.31,11,76.32,32
M4N2A4,798,172,45,7321,27.31,12,76.32,34
M4R1X4,799,172,2,7323,25.77,1,82.99,2
M4N2Y2,800,172,44,7367,27.31,12,76.32,34
M4N1X7,801,172,30,7397,27.31,8,76.32,23
M5N2P6,802,172,1,7398,26.73,0,78.83,1
M4N2Y9,803,172,9,7407,27.31,2,76.32,7
M5N1N1,804,172,33,7440,26.73,9,78.83,26
M5N1M3,805,172,36,7476,26.73,10,78.83,28
M5N1L6,806,172,38,7514,26.73,10,78.83,30
M4N2Z3,807,172,10,7524,27.31,3,76.31,8
M5N1M4,808,172,36,7560,26.73,10,78.82,28
M4N2Y7,809,172,8,7568,27.31,2,76.31,6
M4R1Y4,810,172,4,7572,25.77,1,82.98,3
M8X2T3,811,172,9,7581,25.78,2,82.93,7
M4R1N6,812,172,6,7587,25.77,2,82.98,5
M4R1N7,813,172,10,7597,25.77,3,82.98,8
M4R1N9,814,172,6,7603,25.77,2,82.98,5
M4R1Y3,815,172,6,7609,25.77,2,82.97,5
M4R1X5,816,172,3,7612,25.77,1,82.97,2
M4R1M8,817,172,19,7631,25.77,5,82.97,16
M4R1P7,818,172,8,7639,25.77,2,82.97,7
M4R1Z5,819,172,7,7646,25.77,2,82.97,6
M4R1N8,820,172,15,7661,25.77,4,82.97,12
M4R1P1,821,172,23,7684,25.77,6,82.97,19
M4R1P9,822,172,8,7692,25.77,2,82.97,7
M4R1R1,823,172,8,7700,25.77,2,82.96,7
M4R1Y5,824,172,7,7707,25.77,2,82.96,6
M4R2B1,825,172,5,7712,25.77,1,82.96,4
M4R1Y2,826,172,3,7715,25.77,1,82.96,2
M5N1T2,827,172,1,7716,26.42,0,80.13,1
M5N2L7,828,172,2,7718,26.73,1,78.79,2
M4R1W9,829,172,2,7720,25.77,1,82.94,2
M4W2A5,830,172,5,7725,23.73,1,91.75,5
M4W1Y2,831,172,9,7734,23.73,2,91.75,8
M4W1X4,832,172,20,7754,23.73,5,91.75,18
M4W2B6,833,172,23,7777,23.73,5,91.75,21
M4W1Y1,834,172,17,7794,23.73,4,91.75,16
M4W2A6,835,172,7,7801,23.73,2,91.75,6
M4W2Y2,836,172,5,7806,23.73,1,91.74,5
M4W2B1,837,172,16,7822,23.73,4,91.74,15
M4W1X5,838,172,16,7838,23.73,4,91.74,15
M4W2A9,839,172,16,7854,23.73,4,91.74,15
M4W2W3,840,172,5,7859,23.73,1,91.74,5
M4W2W2,841,172,6,7865,23.73,1,91.74,6
M4W1X6,842,172,4,7869,23.73,1,91.73,4
M5N2P8,843,172,2,7871,26.42,1,80.07,2
M9A4Z5,844,172,41,7912,26.42,11,80.03,33
M5N1T4,845,172,17,7929,26.41,4,80.07,14
L4L2G4,846,172,2,7931,28.41,1,71.37,1
L4L2N5,847,172,4,7935,28.41,1,71.35,3
L4L1M4,848,172,14,7949,28.41,4,71.35,10
L4L2Y5,849,172,15,7964,28.41,4,71.35,11
L4L1M2,850,172,26,7990,28.41,7,71.35,19
L4L1X2,851,172,11,8001,28.41,3,71.34,8
M8Y3X5,852,172,4,8005,28.83,1,69.51,3
M8Y3T5,853,172,2,8007,28.83,1,69.51,1
M8Y3T7,854,172,5,8012,28.83,1,69.50,3
M8Y3X9,855,172,3,8015,28.83,1,69.49,2
M8Y2L9,856,172,15,8030,28.83,4,69.49,10
M8Y3X6,857,172,6,8036,28.83,2,69.49,4
M8Y2M5,858,172,15,8051,28.83,4,69.48,10
M8Y3X8,859,172,3,8054,28.83,1,69.48,2
M8Y3R7,860,172,11,8065,28.83,3,69.48,8
M8Y2L7,861,172,12,8077,28.83,3,69.48,8
M8Y2K9,862,172,13,8090,28.83,4,69.48,9
M8Y2M1,863,172,13,8103,28.83,4,69.48,9
M8Y3P6,864,172,14,8117,28.83,4,69.48,10
M8Y2L8,865,172,14,8131,28.83,4,69.48,10
M8Y2M4,866,172,12,8143,28.83,3,69.48,8
M8Y2N1,867,172,5,8148,28.83,1,69.48,3
M8Y2M9,868,172,7,8155,28.83,2,69.48,5
M8X2C2,869,172,2,8157,26.74,1,78.37,2
M8X2C4,870,172,2,8159,26.74,1,78.37,2
M8X2G1,871,172,2,8161,26.74,1,78.36,2
M8X1K1,872,172,10,8171,26.74,3,78.35,8
M8X1N4,873,172,4,8175,26.74,1,78.35,3
M8X1N6,874,172,5,8180,26.74,1,78.35,4
M8X2G3,875,172,4,8184,26.74,1,78.35,3
M8X2C7,876,172,16,8200,26.74,4,78.34,13
M8X1K2,877,172,7,8207,26.74,2,78.34,5
M8X1K3,878,172,8,8215,26.74,2,78.34,6
M8X1M4,879,172,3,8218,26.74,1,78.34,2
M8X2E1,880,172,17,8235,26.74,5,78.34,13
M8X2G4,881,172,15,8250,26.74,4,78.34,12
M8X1J4,882,172,12,8262,26.74,3,78.34,9
M8X1M3,883,172,12,8274,26.74,3,78.34,9
M8X1M5,884,172,9,8283,26.74,2,78.34,7
M8X2C3,885,172,2,8285,26.74,1,78.34,2
M8X1J5,886,172,8,8293,26.74,2,78.34,6
M5N1P1,887,172,9,8302,26.34,2,80.07,7
M9A5A1,888,172,26,8328,26.44,7,79.62,21
M8X2C5,889,172,2,8330,26.74,1,78.32,2
M8X1J9,890,172,11,8341,26.73,3,78.34,9
M8X2E2,891,172,16,8357,26.73,4,78.34,13
M4N3K1,892,172,2,8359,23.74,0,91.22,2
M5N2S3,893,172,2,8361,26.31,1,80.09,2
M5N2S4,894,172,3,8364,26.31,1,80.08,2
M5N2V5,895,172,9,8373,26.31,2,80.08,7
M4N3R3,896,172,1,8374,23.73,0,91.26,1
M4N1L1,897,172,4,8378,23.74,1,91.21,4
M4N1P2,898,172,5,8383,23.74,1,91.21,5
M5N1S5,899,172,17,8400,26.31,4,80.08,14
M4N3J1,900,172,6,8406,23.74,1,91.21,5
M5N1V4,901,172,18,8424,26.31,5,80.07,14
M4N3H1,902,172,2,8426,23.74,0,91.21,2
M5N1P4,903,172,23,8449,26.31,6,80.07,18
M5N2S2,904,172,6,8455,26.31,2,80.07,5
M5N1S4,905,172,11,8466,26.31,3,80.07,9
M4N1R8,906,172,9,8475,23.74,2,91.20,8
M4N1P4,907,172,2,8477,23.74,0,91.20,2
M5N1S6,908,172,6,8483,26.31,2,80.07,5
M4N1R9,909,172,2,8485,23.73,0,91.24,2
M4N3H9,910,172,2,8487,23.74,0,91.20,2
M4N1R7,911,172,7,8494,23.74,2,91.20,6
M4N3G7,912,172,2,8496,23.73,0,91.22,2
M4N1P3,913,172,5,8501,23.73,1,91.21,5
M5N2S1,914,172,18,8519,26.30,5,80.08,14
M5N2V6,915,172,5,8524,26.30,1,80.07,4
M4N1J5,916,172,24,8548,23.73,6,91.21,22
M5N1S3,917,172,10,8558,26.30,3,80.07,8
M5N1R4,918,172,24,8582,26.30,6,80.07,19
M5N1R5,919,172,12,8594,26.30,3,80.07,10
M4N1K9,920,172,25,8619,23.73,6,91.20,23
M4N1L2,921,172,7,8626,23.73,2,91.20,6
M4N3J2,922,172,4,8630,23.73,1,91.20,4
M4N3K2,923,172,3,8633,23.73,1,91.20,3
M4N3K3,924,172,2,8635,23.73,0,91.20,2
M4N1T8,925,172,8,8643,23.73,2,91.20,7
M4N3J3,926,172,4,8647,23.73,1,91.20,4
M4N3K4,927,172,5,8652,23.73,1,91.20,5
M5N2R8,928,172,4,8656,26.30,1,80.06,3
M4N1L3,929,172,3,8659,23.73,1,91.19,3
M5N2R9,930,172,3,8662,26.30,1,80.05,2
M4N1P5,931,172,3,8665,23.73,1,91.18,3
M2L1E7,932,172,2,8667,24.49,0,87.83,2
M4N1W7,933,172,3,8670,24.49,1,87.81,3
M4N3E9,934,172,1,8671,24.49,0,87.80,1
M4N3H3,935,172,3,8674,24.49,1,87.79,3
M4N3N9,936,172,6,8680,24.49,1,87.79,5
M4N3H6,937,172,7,8687,24.49,2,87.78,6
M4N2G9,938,172,7,8694,24.49,2,87.78,6
M4N1V2,939,172,3,8697,24.49,1,87.78,3
M4N2H3,940,172,7,8704,24.49,2,87.78,6
M4N3G1,941,172,4,8708,24.49,1,87.78,4
M4N3E1,942,172,6,8714,24.49,1,87.78,5
M4N2G1,943,172,14,8728,24.49,3,87.78,12
M4N2H2,944,172,4,8732,24.49,1,87.78,4
M4N1T4,945,172,16,8748,24.49,4,87.78,14
M4N2G7,946,172,10,8758,24.49,2,87.78,9
M2L1C6,947,172,23,8781,24.49,6,87.78,20
M4N3E4,948,172,7,8788,24.49,2,87.78,6
M2L1A3,949,172,10,8798,24.49,2,87.78,9
M4N3C9,950,172,11,8809,24.49,3,87.78,10
M4N2X5,951,172,8,8817,24.49,2,87.78,7
M2L1C7,952,172,32,8849,24.49,8,87.78,28
M4N2E6,953,172,11,8860,24.49,3,87.78,10
M4N2E8,954,172,13,8873,24.49,3,87.78,11
M4N2E5,955,172,10,8883,24.49,2,87.77,9
M4N1V3,956,172,9,8892,24.49,2,87.77,8
M4N2G8,957,172,6,8898,24.49,1,87.77,5
M2L1A1,958,172,6,8904,24.49,1,87.77,5
M4N2G6,959,172,8,8912,24.49,2,87.77,7
M2L1G2,960,172,2,8914,24.49,0,87.77,2
M4N3H4,961,172,20,8934,24.49,5,87.77,18
M4N2E7,962,172,9,8943,24.49,2,87.77,8
M4N3H5,963,172,6,8949,24.49,1,87.77,5
M4N2H1,964,172,9,8958,24.49,2,87.77,8
M4N1W8,965,172,3,8961,24.49,1,87.77,3
M2L1A7,966,172,3,8964,24.49,1,87.77,3
M4N1Y1,967,172,6,8970,24.49,1,87.77,5
M4N2W5,968,172,8,8978,24.49,2,87.76,7
M4N1Y2,969,172,5,8983,24.49,1,87.76,4
M4N1V4,970,172,4,8987,24.49,1,87.76,4
M4N2W4,971,172,7,8994,24.49,2,87.76,6
M4N3E3,972,172,3,8997,24.49,1,87.76,3
M2P1V9,973,172,2,8999,24.48,0,87.80,2
M4N2G3,974,172,6,9005,24.49,1,87.75,5
M4N2X4,975,172,2,9007,24.49,0,87.74,2
M2L1A6,976,172,2,9009,24.49,0,87.73,2
M2P1A4,977,172,15,9024,24.48,4,87.78,13
M2P1A7,978,172,15,9039,24.48,4,87.78,13
M2P1A6,979,172,6,9045,24.48,1,87.77,5
M2P1A8,980,172,10,9055,24.48,2,87.77,9
M2P1A5,981,172,8,9063,24.48,2,87.76,7
M2L1G1,982,172,1,9064,24.49,0,87.71,1
M2L1E3,983,172,21,9085,24.47,5,87.77,18
M4N3E2,984,172,1,9086,24.49,0,87.68,1
M4N2P9,985,172,1,9087,24.49,0,87.68,1
M2P1V7,986,172,2,9089,24.48,0,87.72,2
M2N2K4,987,171,1,9090,29.06,0,67.75,1
M2N2L9,988,171,2,9092,29.06,1,67.73,1
L4J4S7,989,171,18,9110,27.19,5,75.82,14
M2N2K3,990,171,5,9115,29.06,1,67.71,3
M2N1B4,991,171,9,9124,29.06,3,67.70,6
M2N1B2,992,171,15,9139,29.06,4,67.70,10
M2N1A2,993,171,18,9157,29.06,5,67.70,12
M2N1C6,994,171,13,9170,29.06,4,67.70,9
M2N1B5,995,171,7,9177,29.06,2,67.70,5
M2N1B3,996,171,14,9191,29.06,4,67.70,9
M2N1C8,997,171,11,9202,29.06,3,67.70,7
M9A3C2,998,171,6,9208,27.45,2,74.67,4
M2N1A4,999,171,5,9213,29.06,1,67.69,3
M2N2M1,1000,171,4,9217,29.06,1,67.68,3
M4N2X2,1001,171,11,9228,28.23,3,71.25,8
M4N1X6,1002,171,3,9231,28.23,1,71.25,2
M2N1A9,1003,171,4,9235,29.05,1,67.70,3
M4N1T2,1004,171,17,9252,28.23,5,71.25,12
M4N3C2,1005,171,15,9267,28.23,4,71.25,11
M4N1T1,1006,171,11,9278,28.23,3,71.24,8
M4N1W4,1007,171,10,9288,28.23,3,71.24,7
M4N1W5,1008,171,22,9310,28.23,6,71.24,16
M4N2Z2,1009,171,10,9320,28.23,3,71.24,7
M9A1E7,1010,171,5,9325,28.73,1,69.07,3
M4N3C4,1011,171,4,9329,28.23,1,71.23,3
M9A1H2,1012,171,7,9336,28.73,2,69.06,5
M9A2G2,1013,171,6,9342,28.73,2,69.05,4
M9A2H2,1014,171,2,9344,28.73,1,69.04,1
M4N1X5,1015,171,13,9357,28.22,4,71.25,9
M4N1S8,1016,171,8,9365,28.22,2,71.25,6
M9A2H9,1017,171,1,9366,28.73,0,69.04,1
M4N2X9,1018,171,10,9376,28.22,3,71.24,7
M4N2X8,1019,171,12,9388,28.22,3,71.24,9
M4N1X9,1020,171,11,9399,28.22,3,71.24,8
M9A1E3,1021,171,1,9400,28.73,0,69.03,1
M9A2H1,1022,171,4,9404,28.73,1,69.03,3
M4R2B3,1023,171,7,9411,26.42,2,79.03,6
M2N1B1,1024,171,4,9415,29.03,1,67.71,3
M4R1P4,1025,171,36,9451,26.42,10,79.01,28
M4R1R4,1026,171,34,9485,26.42,9,79.01,27
M4R1R3,1027,171,47,9532,26.42,12,79.01,37
M4R1P3,1028,171,31,9563,26.42,8,79.01,24
M4R1N2,1029,171,17,9580,26.42,4,79.01,13
M4R2B2,1030,171,3,9583,26.42,1,79.01,2
M5N2H3,1031,171,11,9594,26.42,3,79.01,9
M5N2H1,1032,171,6,9600,26.42,2,79.01,5
M4R2B4,1033,171,4,9604,26.42,1,79.00,3
M4N0A2,1034,171,1,9605,28.20,0,71.25,1
M5M2Z8,1035,171,1,9606,26.79,0,77.33,1
M5M3H5,1036,171,9,9615,26.79,2,77.24,7
M5M3G1,1037,171,8,9623,26.79,2,77.23,6
M5M3G2,1038,171,9,9632,26.79,2,77.23,7
M5M2Y8,1039,171,3,9635,26.79,1,77.23,2
M9A5A8,1040,171,21,9656,26.29,6,79.36,17
M6C1J7,1041,171,6,9662,28.97,2,67.73,4
M6C1G8,1042,171,9,9671,28.97,3,67.73,6
M6C2V3,1043,171,16,9687,28.97,5,67.72,11
M6C1J6,1044,171,11,9698,28.97,3,67.72,7
M6C2W6,1045,171,12,9710,28.97,3,67.72,8
M6C2W4,1046,171,10,9720,28.97,3,67.71,7
M6C1E8,1047,171,3,9723,28.97,1,67.69,2
L4J4S8,1048,171,12,9735,27.14,3,75.59,9
L4J4R2,1049,171,15,9750,27.14,4,75.58,11
M4W2X7,1050,171,1,9751,25.81,0,81.34,1
L4J4R5,1051,171,14,9765,27.14,4,75.58,11
M4W2E3,1052,171,5,9770,25.81,1,81.34,4
M4W2B4,1053,171,12,9782,25.81,3,81.34,10
M4W2W8,1054,171,4,9786,25.81,1,81.33,3
M4W2E1,1055,171,31,9817,25.81,8,81.33,25
M4W2C8,1056,171,13,9830,25.81,3,81.33,11
M4W2C9,1057,171,25,9855,25.81,6,81.33,20
M4W2C1,1058,171,14,9869,25.81,4,81.33,11
M4W2Y5,1059,171,8,9877,25.81,2,81.33,7
M4W2C7,1060,171,15,9892,25.81,4,81.33,12
M4W2B7,1061,171,16,9908,25.81,4,81.33,13
M4W2W9,1062,171,10,9918,25.81,3,81.33,8
M4W2B5,1063,171,2,9920,25.81,1,81.33,2
M4W2X2,1064,171,10,9930,25.81,3,81.33,8
M4W2B8,1065,171,4,9934,25.81,1,81.32,3
M9B4Y1,1066,171,2,9936,27.36,1,74.59,1
M9B4Z3,1067,171,2,9938,27.36,1,74.58,1
M9B4W5,1068,171,2,9940,27.36,1,74.57,1
M9B2C5,1069,171,9,9949,27.36,2,74.57,7
M9B2K5,1070,171,16,9965,27.36,4,74.57,12
M9B4Z5,1071,171,15,9980,27.36,4,74.56,11
M9B4L2,1072,171,21,10001,27.36,6,74.56,16
M9B5A1,1073,171,6,10007,27.36,2,74.56,4
M9B3M5,1074,171,7,10014,27.36,2,74.56,5
M9B4Z7,1075,171,2,10016,27.36,1,74.56,1
M9B2L6,1076,171,3,10019,27.36,1,74.56,2
M9B5A3,1077,171,8,10027,27.36,2,74.56,6
M9B1Z2,1078,171,13,10040,27.36,4,74.55,10
M9B5A2,1079,171,7,10047,27.36,2,74.55,5
M9B4W6,1080,171,6,10053,27.36,2,74.55,4
M9B2L5,1081,171,7,10060,27.36,2,74.55,5
M9B2K4,1082,171,4,10064,27.36,1,74.54,3
M9B1Z6,1083,171,2,10066,27.36,1,74.53,1
M8X2S4,1084,171,6,10072,26.88,2,76.58,5
M4G3G8,1085,171,21,10093,28.60,6,69.09,15
M9A1W2,1086,171,3,10096,26.93,1,76.31,2
M4R1M9,1087,171,24,10120,25.39,6,82.97,20
M2P0A1,1088,171,1,10121,26.36,0,78.72,1
M9A2N6,1089,171,1,10122,26.88,0,76.41,1
M9A1Y8,1090,171,1,10123,26.88,0,76.39,1
M9A2N3,1091,171,1,10124,26.88,0,76.38,1
M9A1W6,1092,171,1,10125,26.88,0,76.38,1
M9A2N2,1093,171,2,10127,26.88,1,76.38,2
M9A1W4,1094,171,11,10138,26.88,3,76.37,8
M9A1V3,1095,171,12,10150,26.88,3,76.37,9
M9A1V2,1096,171,17,10167,26.88,5,76.36,13
M9A1X6,1097,171,23,10190,26.88,6,76.36,18
M9A1X5,1098,171,18,10208,26.88,5,76.36,14
M9A1Y9,1099,171,15,10223,26.88,4,76.36,11
M9A1Y6,1100,171,15,10238,26.88,4,76.36,11
M9A1W1,1101,171,13,10251,26.88,3,76.36,10
M9A1Y5,1102,171,16,10267,26.88,4,76.36,12
M9A1Z2,1103,171,18,10285,26.88,5,76.36,14
M9A1W9,1104,171,16,10301,26.88,4,76.36,12
M9A1W8,1105,171,11,10312,26.88,3,76.36,8
M9A2N4,1106,171,1,10313,26.88,0,76.36,1
M9A1Z1,1107,171,21,10334,26.88,6,76.36,16
M9A2M9,1108,171,7,10341,26.88,2,76.36,5
M9A1Y7,1109,171,1,10342,26.88,0,76.34,1
M2N0E4,1110,171,1,10343,26.26,0,78.98,1
M4G2T7,1111,171,10,10353,24.36,2,87.20,9
M4G3P3,1112,171,16,10369,24.36,4,87.20,14
M4G2V1,1113,171,27,10396,24.36,7,87.19,24
M4G2R6,1114,171,9,10405,24.36,2,87.19,8
M4G3R1,1115,171,17,10422,24.36,4,87.19,15
M4G2V6,1116,171,19,10441,24.36,5,87.19,17
M4G3P9,1117,171,15,10456,24.36,4,87.19,13
M4G1R5,1118,171,19,10475,24.36,5,87.19,17
M4G2V7,1119,171,9,10484,24.36,2,87.19,8
M4G2R5,1120,171,8,10492,24.36,2,87.19,7
M4G2V5,1121,171,8,10500,24.36,2,87.19,7
M4G3P4,1122,171,5,10505,24.36,1,87.19,4
M4G2V4,1123,171,9,10514,24.36,2,87.19,8
M4G3P7,1124,171,7,10521,24.36,2,87.19,6
L4J3E6,1125,171,6,10527,27.32,2,74.34,4
L4J3C1,1126,171,20,10547,27.32,5,74.33,15
L4J3A4,1127,171,34,10581,27.32,9,74.33,25
L4J3C3,1128,171,7,10588,27.32,2,74.33,5
M4G1R2,1129,171,3,10591,27.92,1,71.70,2
M4G2M4,1130,171,19,10610,27.92,5,71.69,14
M4G2J4,1131,171,9,10619,27.92,3,71.69,6
M4G3P5,1132,171,2,10621,27.92,1,71.69,1
M4G3P2,1133,171,7,10628,27.92,2,71.69,5
M4G2R3,1134,171,16,10644,27.92,4,71.69,11
M4G2K5,1135,171,17,10661,27.92,5,71.69,12
M4G2P2,1136,171,16,10677,27.92,4,71.69,11
M4G2N9,1137,171,14,10691,27.92,4,71.69,10
M4G2M3,1138,171,19,10710,27.92,5,71.69,14
M4G1P9,1139,171,11,10721,27.92,3,71.69,8
M4G2P1,1140,171,21,10742,27.92,6,71.69,15
M4G2R4,1141,171,20,10762,27.92,6,71.69,14
M4G2K6,1142,171,9,10771,27.92,3,71.69,6
L4J7A2,1143,171,10,10781,26.08,3,79.63,8
L4J6Z8,1144,171,10,10791,26.08,3,79.63,8
L4J6Z9,1145,171,15,10806,26.08,4,79.63,12
L4J7A4,1146,171,11,10817,26.08,3,79.62,9
L4J6Y8,1147,171,11,10828,27.25,3,74.54,8
M3A2T3,1148,170,4,10832,26.19,1,79.11,3
M5R3P9,1149,170,2,10834,26.65,1,77.11,2
M3A2T4,1150,170,11,10845,26.19,3,79.10,9
M3A1V8,1151,170,19,10864,26.19,5,79.10,15
M3A2T9,1152,170,41,10905,26.19,11,79.10,32
M3A1W2,1153,170,45,10950,26.19,12,79.10,36
M3A1T3,1154,170,31,10981,26.19,8,79.09,25
M3A2S6,1155,170,15,10996,26.19,4,79.09,12
M3A2S5,1156,170,11,11007,26.19,3,79.09,9
L4L1L6,1157,170,1,11008,27.35,0,74.06,1
M9A4Z3,1158,170,37,11045,26.35,10,78.37,29
M8X2M3,1159,170,8,11053,27.10,2,75.12,6
M8X1T3,1160,170,10,11063,27.10,3,75.11,8
M8X1R2,1161,170,10,11073,27.10,3,75.11,8
M8X1S4,1162,170,12,11085,27.10,3,75.11,9
M8X2K7,1163,170,8,11093,27.10,2,75.11,6
M8X1R3,1164,170,16,11109,27.10,4,75.11,12
M8X1S3,1165,170,13,11122,27.10,4,75.11,10
M8X2K8,1166,170,15,11137,27.10,4,75.11,11
M8X1W4,1167,170,9,11146,27.10,2,75.11,7
M8X2K6,1168,170,3,11149,27.10,1,75.11,2
M8X1T2,1169,170,9,11158,27.10,2,75.10,7
M8X2M5,1170,170,12,11170,27.10,3,75.10,9
M8X1R4,1171,170,13,11183,27.10,4,75.10,10
M8X1T4,1172,170,7,11190,27.10,2,75.10,5
M8X1T5,1173,170,6,11196,27.10,2,75.10,5
M8X2M1,1174,170,9,11205,27.10,2,75.10,7
M8X2L9,1175,170,1,11206,27.10,0,75.09,1
M6S1W9,1176,170,12,11218,25.84,3,80.40,10
M8X2T2,1177,170,15,11233,28.50,4,68.86,10
M9A3W3,1178,170,11,11244,28.70,3,67.91,7
M9A3W5,1179,170,12,11256,28.70,3,67.90,8
M6S4S5,1180,170,5,11261,25.80,1,80.43,4
M6S2H2,1181,170,5,11266,25.80,1,80.43,4
M6S2H1,1182,170,4,11270,25.80,1,80.42,3
M6S2G6,1183,170,10,11280,25.80,3,80.42,8
M6S2G7,1184,170,6,11286,25.80,2,80.42,5
M6S4V5,1185,170,1,11287,25.77,0,80.55,1
M6S2A9,1186,170,2,11289,25.80,1,80.41,2
M6S4K8,1187,170,11,11300,25.80,3,80.41,9
M6S4L1,1188,170,7,11307,25.80,2,80.41,6
M6S2C1,1189,170,10,11317,25.80,3,80.41,8
M6S4K9,1190,170,5,11322,25.80,1,80.41,4
M4N1T7,1191,170,2,11324,25.20,1,83.01,2
M6S4M9,1192,170,15,11339,25.80,4,80.40,12
M6S2A8,1193,170,6,11345,25.80,2,80.40,5
M4N2X1,1194,170,1,11346,24.77,0,84.86,1
M6S4S6,1195,170,6,11352,25.79,2,80.43,5
M6S2B8,1196,170,12,11364,25.79,3,80.42,10
M6S2G4,1197,170,7,11371,25.79,2,80.42,6
M6S4N3,1198,170,2,11373,25.80,1,80.37,2
M6S2G3,1199,170,45,11418,25.79,12,80.41,36
M6S2A7,1200,170,23,11441,25.79,6,80.41,18
M6S2B7,1201,170,41,11482,25.79,11,80.41,33
M6S4S4,1202,170,7,11489,25.79,2,80.41,6
M6S4K7,1203,170,14,11503,25.79,4,80.41,11
M6S2A6,1204,170,6,11509,25.79,2,80.41,5
M6S4N1,1205,170,11,11520,25.79,3,80.41,9
M6S4S7,1206,170,6,11526,25.79,2,80.41,5
M6S2B9,1207,170,6,11532,25.79,2,80.41,5
M4N1H8,1208,170,2,11534,24.77,0,84.82,2
M6S4N2,1209,170,7,11541,25.79,2,80.40,6
M6S4Z3,1210,170,1,11542,25.79,0,80.40,1
M4N1H7,1211,170,3,11545,24.77,1,84.81,3
M4N2W9,1212,170,2,11547,24.77,0,84.80,2
M4N1J1,1213,170,3,11550,24.77,1,84.79,3
M4N1K6,1214,170,22,11572,24.77,5,84.79,19
M4N1G4,1215,170,18,11590,24.77,4,84.79,15
M4N1H5,1216,170,14,11604,24.77,3,84.79,12
M4N1K5,1217,170,25,11629,24.77,6,84.79,21
M4N1N7,1218,170,24,11653,24.77,6,84.79,20
M4N1H6,1219,170,16,11669,24.77,4,84.79,14
M4N3A5,1220,170,6,11675,24.77,1,84.79,5
M4N3A6,1221,170,2,11677,24.77,0,84.79,2
M4N1H9,1222,170,4,11681,24.77,1,84.78,3
M4N3B1,1223,170,6,11687,24.77,1,84.78,5
L4L1W7,1224,170,1,11688,28.36,0,69.20,1
M6S1W8,1225,170,7,11695,25.77,2,80.41,6
L4L2P7,1226,170,13,11708,28.36,4,69.19,9
L4L1R2,1227,170,13,11721,28.36,4,69.19,9
L4L2P1,1228,170,18,11739,28.36,5,69.19,12
L4L1M3,1229,170,5,11744,28.36,1,69.18,3
M6S1X1,1230,170,3,11747,25.77,1,80.40,2
L4L4C1,1231,170,2,11749,28.36,1,69.17,1
M2L2M7,1232,170,1,11750,25.61,0,81.08,1
M2L2M6,1233,170,1,11751,25.61,0,81.08,1
M2L1C1,1234,170,3,11754,25.61,1,81.05,2
M2L1W2,1235,170,1,11755,25.61,0,81.04,1
M2L1W1,1236,170,2,11757,25.61,1,81.03,2
M2L2L1,1237,170,6,11763,25.61,2,81.03,5
M2L1Z8,1238,170,12,11775,25.61,3,81.02,10
M2L2L4,1239,170,11,11786,25.61,3,81.02,9
M2L2L3,1240,170,8,11794,25.61,2,81.02,6
M2L2J8,1241,170,10,11804,25.61,3,81.02,8
M2L2K1,1242,170,11,11815,25.61,3,81.01,9
M2L1B8,1243,170,6,11821,25.61,2,81.01,5
M2L2J7,1244,170,9,11830,25.61,2,81.01,7
M2L2L2,1245,170,8,11838,25.61,2,81.01,6
M2L2K5,1246,170,8,11846,25.61,2,81.01,6
M2L1C2,1247,170,2,11848,25.61,1,81.01,2
M2L2M5,1248,170,2,11850,25.61,1,81.01,2
M2L2K4,1249,170,9,11859,25.61,2,81.01,7
M2L2A1,1250,170,12,11871,25.61,3,81.01,10
M2L2M4,1251,170,3,11874,25.61,1,81.00,2
M2L2J9,1252,170,11,11885,25.61,3,81.00,9
M2L2K9,1253,170,9,11894,25.61,2,81.00,7
M6S1X2,1254,170,1,11895,25.77,0,80.31,1
M2L2K6,1255,170,7,11902,25.61,2,80.99,6
M2L1C3,1256,170,2,11904,25.61,1,80.99,2
L3T7A6,1257,170,13,11917,25.59,3,81.04,11
M9R1T5,1258,170,17,11934,27.74,5,71.62,12
M9P3N6,1259,170,2,11936,27.73,1,71.66,1
M6C2V9,1260,170,4,11940,28.62,1,67.73,3
M3C1P3,1261,170,3,11943,26.34,1,77.61,2
M3H5Z9,1262,170,32,11975,27.77,9,71.37,23
M8Y3T6,1263,170,9,11984,28.20,3,69.49,6
M8Y2K8,1264,170,16,12000,28.20,5,69.48,11
M8Y3R8,1265,170,11,12011,28.20,3,69.48,8
M8Y2N4,1266,170,12,12023,28.20,3,69.48,8
M5N3A8,1267,170,41,12064,28.79,12,66.90,27
M9B4Z2,1268,170,2,12066,27.02,1,74.56,1
L4L1L7,1269,170,3,12069,27.09,1,74.14,2
L4J3E8,1270,170,7,12076,27.36,2,72.97,5
M9A3V9,1271,170,12,12088,28.06,3,69.88,8
M4S2R1,1272,169,15,12103,27.49,4,72.33,11
M4S1K4,1273,169,20,12123,27.49,5,72.33,14
M4S1K2,1274,169,35,12158,27.49,10,72.33,25
M4S1M5,1275,169,28,12186,27.49,8,72.32,20
M4S1M3,1276,169,17,12203,27.49,5,72.32,12
M4S1H5,1277,169,14,12217,27.49,4,72.32,10
M4S2R5,1278,169,14,12231,27.49,4,72.32,10
M4S1H3,1279,169,17,12248,27.49,5,72.32,12
M4S1K1,1280,169,17,12265,27.49,5,72.32,12
M4S2R7,1281,169,6,12271,27.49,2,72.32,4
M4S2P6,1282,169,14,12285,27.49,4,72.32,10
M4S1K3,1283,169,13,12298,27.49,4,72.32,9
L4J4R8,1284,169,18,12316,26.93,5,74.71,13
L4J1K1,1285,169,7,12323,25.80,2,79.60,6
M8X2T4,1286,169,5,12328,28.58,1,67.53,3
L4J1J9,1287,169,4,12332,25.80,1,79.57,3
M8Y2N3,1288,169,16,12348,27.96,4,70.19,11
M8Y3V3,1289,169,11,12359,27.96,3,70.19,8
M8Y3P3,1290,169,13,12372,27.96,4,70.19,9
M9A5A7,1291,169,17,12389,26.43,4,76.81,13
M4G0A9,1292,169,11,12400,29.01,3,65.63,7
M4G2C4,1293,169,7,12407,28.22,2,69.04,5
M9A3Z6,1294,169,21,12428,26.77,6,75.30,16
M9A4A1,1295,169,7,12435,26.77,2,75.29,5
M9A3J1,1296,169,6,12441,26.77,2,75.29,5
L4J4V8,1297,169,10,12451,27.13,3,73.70,7
M2P1G4,1298,169,16,12467,25.97,4,78.66,13
M2P1H7,1299,169,14,12481,25.97,4,78.66,11
M2P1G3,1300,169,17,12498,25.97,4,78.66,13
M2L1K5,1301,169,8,12506,25.97,2,78.66,6
M2P1C4,1302,169,15,12521,25.97,4,78.66,12
M2P1E3,1303,169,9,12530,25.97,2,78.65,7
M2L1K7,1304,169,13,12543,25.97,3,78.65,10
M2P1C2,1305,169,13,12556,25.97,3,78.65,10
M2P1E5,1306,169,13,12569,25.97,3,78.65,10
M2P1E4,1307,169,17,12586,25.97,4,78.65,13
M2P1C5,1308,169,12,12598,25.97,3,78.65,9
M2P1C3,1309,169,9,12607,25.97,2,78.65,7
M9B5K2,1310,169,1,12608,26.93,0,74.45,1
M9B3G4,1311,169,2,12610,26.93,1,74.43,1
M9B5X3,1312,169,1,12611,26.93,0,74.43,1
M9B5X7,1313,169,4,12615,26.93,1,74.43,3
M9B3C2,1314,169,5,12620,26.93,1,74.42,4
M9B3C1,1315,169,5,12625,26.93,1,74.42,4
M9B5X9,1316,169,4,12629,26.93,1,74.42,3
M9B3E4,1317,169,13,12642,26.93,4,74.41,10
M9B3C5,1318,169,7,12649,26.93,2,74.41,5
M9B5K3,1319,169,17,12666,26.93,5,74.41,13
M9B5X8,1320,169,18,12684,26.93,5,74.41,13
M9B5Y5,1321,169,1,12685,26.93,0,74.41,1
M9B3B7,1322,169,19,12704,26.93,5,74.41,14
M9B5X5,1323,169,18,12722,26.93,5,74.41,13
M9B5Y2,1324,169,2,12724,26.93,1,74.40,1
M9B3G1,1325,169,8,12732,26.93,2,74.40,6
M9B5Y3,1326,169,4,12736,26.93,1,74.39,3
M9B5X4,1327,169,2,12738,26.93,1,74.39,1
M4G1C6,1328,169,7,12745,26.35,2,76.89,5
M2N5K8,1329,169,1,12746,24.24,0,85.96,1
M6C1W3,1330,169,10,12756,27.36,3,72.42,7
M2N3Z6,1331,169,5,12761,24.24,1,85.93,4
M8X2T1,1332,169,6,12767,28.61,2,66.99,4
M2N5H3,1333,169,2,12769,24.24,0,85.92,2
M2N3X8,1334,169,13,12782,24.24,3,85.92,11
M2N3V8,1335,169,13,12795,24.24,3,85.92,11
M2N5K9,1336,169,10,12805,24.24,2,85.92,9
M2N3X7,1337,169,14,12819,24.24,3,85.92,12
M2N6R1,1338,169,2,12821,24.24,0,85.92,2
M2N3X9,1339,169,13,12834,24.24,3,85.92,11
M2N3V6,1340,169,11,12845,24.24,3,85.91,9
M2N3S8,1341,169,15,12860,24.24,4,85.91,13
M2N3V7,1342,169,10,12870,24.24,2,85.91,9
M2N3Z7,1343,169,14,12884,24.24,3,85.91,12
M2N3V9,1344,169,8,12892,24.24,2,85.91,7
M2N3S9,1345,169,10,12902,24.24,2,85.91,9
M2N3S7,1346,169,13,12915,24.24,3,85.91,11
M2N3P8,1347,169,14,12929,24.24,3,85.91,12
M2N5L1,1348,169,5,12934,24.24,1,85.90,4
M2N3X6,1349,169,5,12939,24.24,1,85.90,4
M2N6P2,1350,169,1,12940,24.24,0,85.89,1
M9A3L5,1351,169,8,12948,25.31,2,81.21,6
M5N2H2,1352,169,19,12967,26.03,5,78.06,15
M6C3H3,1353,169,3,12970,27.04,1,73.52,2
M4N3M1,1354,169,4,12974,25.29,1,81.03,3
M4N3L5,1355,169,7,12981,25.29,2,81.03,6
M4P2T3,1356,169,5,12986,25.29,1,81.03,4
M4P2S7,1357,169,4,12990,25.29,1,81.02,3
M4P2R2,1358,169,5,12995,25.29,1,81.02,4
M4P1W9,1359,169,5,13000,25.29,1,81.02,4
M4N3M4,1360,169,5,13005,25.29,1,81.02,4
M4N3J6,1361,169,8,13013,25.29,2,81.02,6
M4P1W5,1362,169,5,13018,25.29,1,81.02,4
M4P2T4,1363,169,4,13022,25.29,1,81.02,3
M4P2S6,1364,169,4,13026,25.29,1,81.02,3
M4N3L6,1365,169,21,13047,25.29,5,81.02,17
M4P1X4,1366,169,6,13053,25.29,2,81.02,5
M4N3H8,1367,169,8,13061,25.29,2,81.02,6
M4N3J5,1368,169,25,13086,25.29,6,81.02,20
M4N1A8,1369,169,8,13094,25.29,2,81.02,6
M4N3L7,1370,169,8,13102,25.29,2,81.02,6
M4P2V2,1371,169,5,13107,25.29,1,81.02,4
M4P1W7,1372,169,4,13111,25.29,1,81.02,3
M4N3L8,1373,169,4,13115,25.29,1,81.01,3
M4N1B4,1374,169,12,13127,25.29,3,81.01,10
M9B4Y9,1375,169,1,13128,26.75,0,74.69,1
M4N3J4,1376,169,2,13130,25.29,1,81.01,2
M4N1B1,1377,169,6,13136,25.29,2,81.01,5
M4P1W3,1378,169,17,13153,25.29,4,81.01,14
M4N3M3,1379,169,10,13163,25.29,3,81.01,8
M4N3L4,1380,169,10,13173,25.29,3,81.01,8
M4P2P4,1381,169,4,13177,25.29,1,81.01,3
M4N0A1,1382,169,1,13178,25.29,0,81.01,1
M4N3H7,1383,169,6,13184,25.29,2,81.01,5
M4P1X2,1384,169,6,13190,25.29,2,81.01,5
M4P2V1,1385,169,6,13196,25.29,2,81.01,5
M4N3L9,1386,169,7,13203,25.29,2,81.01,6
M4P2T9,1387,169,3,13206,25.29,1,81.01,2
M4P1X6,1388,169,4,13210,25.29,1,81.01,3
M4N3P3,1389,169,6,13216,25.29,2,81.01,5
M4P2R3,1390,169,4,13220,25.29,1,81.01,3
M4P2S2,1391,169,6,13226,25.29,2,81.00,5
M4P2P3,1392,169,5,13231,25.29,1,81.00,4
M4G2X9,1393,169,1,13232,29.04,0,64.75,1
M4P2S1,1394,169,4,13236,25.29,1,81.00,3
M4N3M2,1395,169,2,13238,25.29,1,80.99,2
M8X2R7,1396,169,3,13241,26.29,1,76.65,2
M4G2Y2,1397,169,4,13245,29.04,1,64.73,3
M4G2Y6,1398,169,18,13263,29.04,5,64.73,12
M4G2Y3,1399,169,3,13266,29.04,1,64.73,2
M8X2S6,1400,169,4,13270,26.29,1,76.63,3
M8X1X1,1401,169,3,13273,26.29,1,76.62,2
M4G2Y1,1402,169,2,13275,29.04,1,64.68,1
M8X2R5,1403,169,10,13285,26.28,3,76.63,8
M8X2S7,1404,169,11,13296,26.28,3,76.63,8
M8X2P9,1405,169,11,13307,26.28,3,76.62,8
M8X1G8,1406,169,9,13316,26.28,2,76.62,7
M8X1V2,1407,169,7,13323,26.28,2,76.62,5
M9B2K1,1408,169,6,13329,26.75,2,74.58,4
M4W2E8,1409,169,5,13334,26.22,1,76.87,4
M4W3X4,1410,169,4,13338,26.22,1,76.87,3
M4W3X3,1411,169,7,13345,26.22,2,76.87,5
M4W2E6,1412,169,55,13400,26.22,14,76.87,42
M4W2G2,1413,169,17,13417,26.22,4,76.87,13
M4W3X5,1414,169,19,13436,26.22,5,76.86,15
M9B2B3,1415,169,7,13443,26.75,2,74.57,5
M4W2E7,1416,169,20,13463,26.22,5,76.86,15
M4W2G3,1417,169,33,13496,26.22,9,76.86,25
M4W2E9,1418,169,17,13513,26.22,4,76.86,13
M4W2G1,1419,169,12,13525,26.22,3,76.86,9
M9B4Y8,1420,169,24,13549,26.75,6,74.56,18
M9B4Y2,1421,169,12,13561,26.75,3,74.56,9
M9B4Y4,1422,169,33,13594,26.75,9,74.56,25
M4G2Z6,1423,169,2,13596,26.21,1,76.89,2
M4G1A2,1424,169,3,13599,26.21,1,76.89,2
M4W3X2,1425,169,3,13602,26.22,1,76.85,2
M9B2B2,1426,169,10,13612,26.75,3,74.55,7
M9B2K2,1427,169,3,13615,26.75,1,74.55,2
M4G1A4,1428,169,5,13620,26.21,1,76.89,4
M8X1W7,1429,169,5,13625,26.28,1,76.58,4
M4G1A9,1430,169,8,13633,26.21,2,76.88,6
M4G1B8,1431,169,1,13634,26.21,0,76.88,1
M4G2Y7,1432,169,8,13642,26.21,2,76.87,6
M4G1A8,1433,169,14,13656,26.21,4,76.87,11
M4G1A1,1434,169,11,13667,26.21,3,76.87,8
M4G1B2,1435,169,12,13679,26.21,3,76.87,9
M4G1A5,1436,169,5,13684,26.21,1,76.87,4
M4G2Z3,1437,169,3,13687,26.21,1,76.87,2
M4G1A6,1438,169,17,13704,26.21,4,76.86,13
M3B3C8,1439,169,5,13709,25.82,1,78.55,4
M4G1A3,1440,169,8,13717,26.21,2,76.86,6
M4G2Z1,1441,169,4,13721,26.21,1,76.86,3
M3B3L5,1442,169,7,13728,25.82,2,78.55,5
M3B3M6,1443,169,14,13742,25.82,4,78.55,11
M3B3C2,1444,169,22,13764,25.82,6,78.54,17
M4G1B4,1445,169,6,13770,26.21,2,76.85,5
M3B3L3,1446,169,27,13797,25.82,7,78.54,21
M3B3G5,1447,169,10,13807,25.82,3,78.54,8
M3B3E8,1448,169,6,13813,25.82,2,78.54,5
M3B3B9,1449,169,20,13833,25.82,5,78.54,16
M3B3B8,1450,169,9,13842,25.82,2,78.54,7
M4G2Y9,1451,169,4,13846,26.21,1,76.85,3
M4G2Y8,1452,169,2,13848,26.21,1,76.84,2
M3B3C4,1453,169,2,13850,25.81,1,78.55,2
M3B3E5,1454,169,13,13863,25.81,3,78.55,10
L4J1Z6,1455,169,4,13867,25.78,1,78.67,3
M3B3C1,1456,169,20,13887,25.81,5,78.54,16
M3B3C5,1457,169,26,13913,25.81,7,78.54,20
M3B3C3,1458,169,2,13915,25.82,1,78.50,2
M4S2V8,1459,169,18,13933,26.03,5,77.55,14
M4S1M9,1460,169,11,13944,26.03,3,77.55,9
M5N2B4,1461,168,5,13949,26.51,1,75.43,4
L3T1C3,1462,168,1,13950,27.62,0,70.55,1
M3H5Z6,1463,168,42,13992,27.43,12,71.37,30
M5P1L3,1464,168,4,13996,26.65,1,74.75,3
M3H6A2,1465,168,20,14016,27.43,5,71.37,14
M8Y3Z2,1466,168,2,14018,27.69,1,70.21,1
M8Y2M8,1467,168,2,14020,27.69,1,70.20,1
M8Y2P2,1468,168,2,14022,27.69,1,70.20,1
M8Y3Z3,1469,168,1,14023,27.69,0,70.20,1
M8Y2P3,1470,168,1,14024,27.69,0,70.20,1
M8Y2N9,1471,168,6,14030,27.69,2,70.20,4
M8Y2N5,1472,168,17,14047,27.69,5,70.19,12
M8Y2P6,1473,168,16,14063,27.69,4,70.19,11
M8Y3V1,1474,168,7,14070,27.69,2,70.19,5
M8Y3R4,1475,168,13,14083,27.69,4,70.19,9
M8Y3R6,1476,168,15,14098,27.69,4,70.19,11
M8Y2N8,1477,168,15,14113,27.69,4,70.19,11
M8Y3V2,1478,168,7,14120,27.69,2,70.19,5
M8Y3T8,1479,168,16,14136,27.69,4,70.19,11
M8Y3T9,1480,168,6,14142,27.69,2,70.19,4
M8Y2N6,1481,168,13,14155,27.69,4,70.19,9
M8Y2N7,1482,168,12,14167,27.69,3,70.19,8
M8Y3R5,1483,168,18,14185,27.69,5,70.19,13
M4R2C5,1484,168,21,14206,28.44,6,66.94,14
M8Y3P5,1485,168,16,14222,27.69,4,70.18,11
M4R1G2,1486,168,27,14249,28.44,8,66.93,18
M8Y2P1,1487,168,6,14255,27.69,2,70.18,4
M8Y2P5,1488,168,12,14267,27.69,3,70.18,8
M8Y3R3,1489,168,11,14278,27.69,3,70.18,8
M8Y3Z1,1490,168,3,14281,27.69,1,70.16,2
M8Y2N2,1491,168,3,14284,27.69,1,70.16,2
L3T1J2,1492,168,3,14287,27.62,1,70.45,2
L3T2K5,1493,168,3,14290,27.62,1,70.45,2
M5N0A1,1494,168,43,14333,28.44,12,66.90,29
L3T1G3,1495,168,8,14341,27.62,2,70.43,6
L3T1J1,1496,168,20,14361,27.62,6,70.43,14
M8Y3V4,1497,168,2,14363,27.69,1,70.13,1
L3T2N6,1498,168,7,14370,27.62,2,70.43,5
L3T2N5,1499,168,7,14377,27.62,2,70.43,5
L3T1J3,1500,168,19,14396,27.62,5,70.42,13
L4J7A3,1501,168,11,14407,25.49,3,79.63,9
L4J6Y9,1502,168,10,14417,25.49,3,79.63,8
L4J7A1,1503,168,18,14435,25.48,5,79.63,14
M9A2K7,1504,168,1,14436,27.75,0,69.80,1
L3T1J6,1505,168,1,14437,27.62,0,70.35,1
M8Z0A3,1506,168,43,14480,26.33,11,75.77,33
M8Z0A2,1507,168,31,14511,26.33,8,75.76,23
M5P3E7,1508,168,18,14529,26.94,5,73.05,13
M5P2R9,1509,168,13,14542,26.94,4,73.04,9
M5P3E8,1510,168,15,14557,26.94,4,73.04,11
M5P1Z4,1511,168,9,14566,26.94,2,73.04,7
L4J2B4,1512,168,4,14570,27.12,1,72.26,3
L4J1E2,1513,168,3,14573,27.12,1,72.26,2
M2L2E5,1514,168,18,14591,27.82,5,69.22,12
M2L2E4,1515,168,20,14611,27.82,6,69.22,14
M2L2E6,1516,168,32,14643,27.82,9,69.22,22
M2L2W4,1517,168,20,14663,27.82,6,69.22,14
M2L2V2,1518,168,17,14680,27.82,5,69.22,12
M2L2C8,1519,168,13,14693,27.82,4,69.22,9
M2L2W1,1520,168,20,14713,27.82,6,69.22,14
L4J1Y9,1521,168,5,14718,27.12,1,72.25,4
L4J7A5,1522,168,10,14728,27.12,3,72.25,7
M2L2E3,1523,168,26,14754,27.82,7,69.22,18
M2L2C6,1524,168,12,14766,27.82,3,69.22,8
L4J2B5,1525,168,4,14770,27.12,1,72.25,3
M2L2X1,1526,168,6,14776,27.82,2,69.22,4
L4J1G5,1527,168,15,14791,27.12,4,72.25,11
L4J7A7,1528,168,10,14801,27.12,3,72.25,7
L4J7A6,1529,168,18,14819,27.12,5,72.25,13
M2L2X3,1530,168,11,14830,27.82,3,69.21,8
L4J2E5,1531,168,4,14834,27.12,1,72.25,3
L4J1E7,1532,168,13,14847,27.12,4,72.25,9
L4J1E8,1533,168,19,14866,27.12,5,72.25,14
M5P1Z2,1534,168,4,14870,26.94,1,73.03,3
L4J1C8,1535,168,12,14882,27.12,3,72.24,9
L4J1G3,1536,168,2,14884,27.12,1,72.24,1
L4J7P2,1537,168,2,14886,27.12,1,72.24,1
L4J6Y3,1538,168,18,14904,26.59,5,74.53,13
L4J6Y7,1539,168,10,14914,26.59,3,74.53,7
L4J7Z6,1540,168,1,14915,27.12,0,72.23,1
L4J2E6,1541,168,1,14916,27.12,0,72.22,1
L4J1C9,1542,168,3,14919,27.12,1,72.21,2
M9R1G3,1543,168,2,14921,29.46,1,62.07,1
M9R1G4,1544,168,2,14923,29.46,1,62.05,1
M9R1G5,1545,168,2,14925,29.46,1,62.04,1
M8X2K5,1546,168,35,14960,26.05,9,76.78,27
M8X1W5,1547,168,24,14984,26.05,6,76.78,18
M4G1V3,1548,168,4,14988,27.73,1,69.47,3
M4G1V1,1549,168,13,15001,27.73,4,69.46,9
M4G1V2,1550,168,17,15018,27.73,5,69.46,12
M4G1R9,1551,168,20,15038,27.73,6,69.46,14
M4G3J6,1552,168,17,15055,27.73,5,69.46,12
M4G3J4,1553,168,6,15061,27.73,2,69.46,4
M4G3G4,1554,168,15,15076,27.73,4,69.45,10
M8X2V3,1555,168,14,15090,27.01,4,72.55,10
M8X2V6,1556,168,21,15111,27.01,6,72.55,15
M8X2V1,1557,168,5,15116,27.01,1,72.54,4
M8X2T8,1558,168,6,15122,27.01,2,72.54,4
M5P2W8,1559,168,4,15126,26.47,1,74.85,3
M5P2Z8,1560,168,6,15132,26.47,2,74.85,4
M5P1T7,1561,168,11,15143,26.47,3,74.85,8
M8Y3T2,1562,168,1,15144,27.78,0,69.17,1
M5P1W4,1563,168,13,15157,26.47,3,74.84,10
M8Y4A6,1564,168,2,15159,27.78,1,69.16,1
M8Y3W9,1565,168,4,15163,27.78,1,69.16,3
M8Y2B1,1566,168,10,15173,27.78,3,69.16,7
M8Y2H7,1567,168,10,15183,27.78,3,69.15,7
M8Y3X2,1568,168,5,15188,27.78,1,69.15,3
M8Y3W6,1569,168,4,15192,27.78,1,69.15,3
M4B2Y7,1570,168,4,15196,28.37,1,66.59,3
M5P3A1,1571,168,2,15198,26.46,1,74.87,1
M8Y2J7,1572,168,15,15213,27.78,4,69.15,10
M8Y3W7,1573,168,8,15221,27.78,2,69.15,6
M8Y2J3,1574,168,12,15233,27.78,3,69.15,8
M8Y2H8,1575,168,13,15246,27.78,4,69.15,9
M8Y2H3,1576,168,14,15260,27.78,4,69.15,10
M8Y2E9,1577,168,12,15272,27.78,3,69.15,8
M8Y2J6,1578,168,11,15283,27.78,3,69.15,8
M8X1S5,1579,168,3,15286,25.99,1,76.90,2
M8Y2J2,1580,168,11,15297,27.78,3,69.14,8
M8Y3Z7,1581,168,8,15305,27.78,2,69.14,6
M8Y2H4,1582,168,13,15318,27.78,4,69.14,9
M8Y2K2,1583,168,14,15332,27.78,4,69.14,10
M8Y3W8,1584,168,1,15333,27.78,0,69.14,1
M4N3G2,1585,168,1,15334,23.21,0,88.94,1
M8Y2A7,1586,168,5,15339,27.78,1,69.14,3
M8Y2A8,1587,168,4,15343,27.78,1,69.14,3
M8Y2K7,1588,168,14,15357,27.78,4,69.14,10
M4B2Y4,1589,168,17,15374,28.37,5,66.58,11
M8Y2G5,1590,168,6,15380,27.78,2,69.14,4
M8Y3X1,1591,168,5,15385,27.78,1,69.13,3
M8Y3X3,1592,168,4,15389,27.78,1,69.13,3
M5P2Z6,1593,168,9,15398,26.46,2,74.85,7
M5P2Z4,1594,168,4,15402,26.46,1,74.85,3
M5P1W6,1595,168,12,15414,26.46,3,74.85,9
M5P1V3,1596,168,11,15425,26.46,3,74.85,8
M5P1T2,1597,168,18,15443,26.46,5,74.85,13
M4B2Y8,1598,168,6,15449,28.37,2,66.57,4
M5P1S7,1599,168,16,15465,26.46,4,74.85,12
M5P1T6,1600,168,8,15473,26.46,2,74.84,6
M5P1T3,1601,168,11,15484,26.46,3,74.84,8
M5P1W3,1602,168,11,15495,26.46,3,74.84,8
M5P1M7,1603,168,6,15501,26.46,2,74.84,4
M5P1M8,1604,168,8,15509,26.46,2,74.84,6
M5P1V4,1605,168,4,15513,26.46,1,74.84,3
L3T6X3,1606,168,16,15529,24.56,4,83.07,13
M5M3N2,1607,168,2,15531,27.19,1,71.67,1
L3T6Z4,1608,168,16,15547,24.56,4,83.07,13
M4N3G4,1609,168,2,15549,23.21,0,88.91,2
L3T6Z5,1610,168,16,15565,24.56,4,83.06,13
L3T6X5,1611,168,17,15582,24.56,4,83.06,14
L3T6Z7,1612,168,17,15599,24.56,4,83.06,14
M5P1V5,1613,168,3,15602,26.46,1,74.83,2
M4N3J8,1614,168,2,15604,23.21,0,88.90,2
M5M1K8,1615,168,39,15643,27.19,11,71.66,28
M5M1M6,1616,168,43,15686,27.19,12,71.66,31
M8Y3S3,1617,168,1,15687,29.87,0,60.05,1
M5M1J1,1618,168,40,15727,27.19,11,71.66,29
L3T6Z6,1619,168,8,15735,24.56,2,83.05,7
M4N3J7,1620,168,9,15744,23.21,2,88.89,8
M5M3J9,1621,168,2,15746,27.19,1,71.65,1
M4N1E5,1622,168,9,15755,23.21,2,88.89,8
M4N1G8,1623,168,7,15762,23.21,2,88.88,6
M4N2X3,1624,168,9,15771,27.95,3,68.35,6
M5P3A2,1625,168,1,15772,26.46,0,74.80,1
M4N3G5,1626,168,1,15773,23.20,0,88.91,1
M8Y3S9,1627,168,1,15774,27.78,0,69.07,1
M8X1R5,1628,168,37,15811,25.97,10,76.91,28
M4N1C9,1629,168,6,15817,23.20,1,88.89,5
M4N1G9,1630,168,6,15823,23.20,1,88.89,5
M8Y3V9,1631,168,4,15827,29.87,1,60.00,2
M4N1J4,1632,168,12,15839,23.20,3,88.89,11
M4N1E1,1633,168,3,15842,23.20,1,88.88,3
M4N1J6,1634,168,7,15849,23.20,2,88.88,6
M4N1E4,1635,168,9,15858,23.20,2,88.88,8
M4N1B5,1636,168,5,15863,23.20,1,88.88,4
M4N1B3,1637,168,7,15870,23.20,2,88.88,6
M5P2W7,1638,168,1,15871,26.46,0,74.75,1
M4N1C8,1639,168,8,15879,23.20,2,88.88,7
M4N3J9,1640,168,3,15882,23.20,1,88.87,3
M4N3G6,1641,168,1,15883,23.20,0,88.86,1
M8X1L8,1642,168,7,15890,27.30,2,71.08,5
M8X1L6,1643,168,6,15896,27.30,2,71.08,4
M4G3J8,1644,168,15,15911,25.69,4,78.06,12
M8X2K2,1645,168,6,15917,27.30,2,71.08,4
M8X2H3,1646,168,10,15927,27.30,3,71.08,7
M8X2E8,1647,168,8,15935,27.30,2,71.08,6
M8X2L5,1648,168,7,15942,27.30,2,71.08,5
M8X2L2,1649,168,10,15952,27.30,3,71.07,7
M8X1L5,1650,168,6,15958,27.30,2,71.07,4
M8X2L7,1651,168,12,15970,27.30,3,71.07,9
M8X2H2,1652,168,5,15975,27.30,1,71.07,4
M8X2H1,1653,168,6,15981,27.30,2,71.07,4
M8X2J4,1654,168,11,15992,27.30,3,71.07,8
M8X1M1,1655,168,6,15998,27.30,2,71.07,4
M8X2L1,1656,168,13,16011,27.30,4,71.07,9
M8X2L3,1657,168,12,16023,27.30,3,71.07,9
M8X2K1,1658,168,9,16032,27.30,2,71.07,6
M8X2J2,1659,168,9,16041,27.30,2,71.07,6
M8X1L4,1660,168,4,16045,27.30,1,71.07,3
M8X2K9,1661,168,13,16058,27.30,4,71.07,9
M8X2H4,1662,168,11,16069,27.30,3,71.07,8
M8X2E6,1663,168,4,16073,27.30,1,71.07,3
M8X2K3,1664,168,12,16085,27.30,3,71.07,9
M8X2J5,1665,168,7,16092,27.30,2,71.07,5
M8X2J9,1666,168,16,16108,27.30,4,71.06,11
M8X2J3,1667,168,8,16116,27.30,2,71.06,6
M8X1L2,1668,168,4,16120,27.30,1,71.06,3
M8X1L3,1669,168,3,16123,27.30,1,71.06,2
M8X2M2,1670,168,2,16125,24.54,0,82.96,2
M8X2R1,1671,168,3,16128,24.54,1,82.95,2
M8X2R2,1672,168,2,16130,24.54,0,82.95,2
M8X2W7,1673,168,1,16131,27.30,0,70.99,1
M8X1P7,1674,168,1,16132,25.88,0,77.14,1
M8X1S2,1675,168,14,16146,24.54,3,82.94,12
M8X1T1,1676,168,18,16164,24.54,4,82.94,15
M8X1S7,1677,168,18,16182,24.54,4,82.94,15
M8X1S6,1678,168,18,16200,24.54,4,82.94,15
M8X1P9,1679,168,14,16214,24.54,3,82.94,12
M8X1S1,1680,168,12,16226,24.54,3,82.94,10
M8X2L8,1681,168,1,16227,24.54,0,82.94,1
M8X1R1,1682,168,12,16239,24.54,3,82.94,10
M8X2R3,1683,168,7,16246,24.54,2,82.93,6
M8X2R4,1684,168,6,16252,24.54,1,82.93,5
M8X1R6,1685,168,4,16256,25.88,1,77.12,3
M8X1R7,1686,168,5,16261,25.88,1,77.11,4
M8X1P8,1687,168,3,16264,25.88,1,77.11,2
M8X2J1,1688,168,12,16276,25.88,3,77.11,9
M8X1R8,1689,168,4,16280,25.88,1,77.11,3
M8X2H9,1690,168,11,16291,25.88,3,77.11,8
M8X1P1,1691,168,2,16293,25.88,1,77.11,2
M8X1R9,1692,168,13,16306,25.88,3,77.10,10
M8X1P2,1693,168,3,16309,25.88,1,77.10,2
M8X1N9,1694,168,2,16311,25.88,1,77.09,2
M8X1P6,1695,168,1,16312,25.88,0,77.08,1
M4S1S7,1696,167,11,16323,25.76,3,77.56,9
M4S2T1,1697,167,17,16340,25.76,4,77.56,13
M4S1S9,1698,167,11,16351,25.76,3,77.55,9
L4J4V7,1699,167,16,16367,27.74,4,68.98,11
M4S2W6,1700,167,17,16384,25.76,4,77.55,13
M4S1N1,1701,167,11,16395,25.76,3,77.55,9
M4S2V7,1702,167,19,16414,25.76,5,77.55,15
M4S1S6,1703,167,11,16425,25.76,3,77.55,9
M4S1M8,1704,167,11,16436,25.76,3,77.55,9
M4S2T9,1705,167,15,16451,25.76,4,77.55,12
M4S2T8,1706,167,15,16466,25.76,4,77.54,12
L4J7S4,1707,167,35,16501,25.81,9,77.26,27
M5N3A9,1708,167,48,16549,28.20,14,66.90,32
M9B2V6,1709,167,14,16563,29.19,4,62.56,9
M9B3N8,1710,167,2,16565,29.19,1,62.56,1
M9B2V1,1711,167,12,16577,29.19,4,62.56,8
M9B5G8,1712,167,3,16580,29.19,1,62.56,2
L4J4T7,1713,167,17,16597,27.75,5,68.79,12
M2N1T5,1714,167,12,16609,28.21,3,66.68,8
M2N2M7,1715,167,5,16614,28.21,1,66.68,3
M2N2L2,1716,167,5,16619,28.21,1,66.68,3
M9A2L1,1717,167,1,16620,27.48,0,69.84,1
M9A1L2,1718,167,12,16632,27.48,3,69.84,8
M9A1L3,1719,167,11,16643,27.48,3,69.83,8
M2N2M6,1720,167,7,16650,28.21,2,66.67,5
M2N1T7,1721,167,15,16665,28.21,4,66.67,10
M2N1W1,1722,167,11,16676,28.21,3,66.67,7
M9A1J3,1723,167,1,16677,27.47,0,69.87,1
M9A1K2,1724,167,4,16681,27.47,1,69.87,3
M9A1J8,1725,167,2,16683,27.48,1,69.83,1
M2N1T8,1726,167,7,16690,28.21,2,66.66,5
M9A1L5,1727,167,4,16694,27.47,1,69.86,3
M9A1J5,1728,167,2,16696,27.47,1,69.85,1
L4J7A8,1729,167,9,16705,27.06,2,71.62,6
M9A1K6,1730,167,11,16716,27.47,3,69.84,8
M9A1J9,1731,167,14,16730,27.47,4,69.84,10
M9A1J7,1732,167,8,16738,27.47,2,69.84,6
M9B2L2,1733,167,6,16744,26.38,2,74.56,4
M9A3K4,1734,167,9,16753,27.47,2,69.84,6
M9A3K7,1735,167,12,16765,27.47,3,69.84,8
M9A1L4,1736,167,5,16770,27.47,1,69.84,3
M9A1M2,1737,167,10,16780,27.47,3,69.84,7
M9A3K6,1738,167,11,16791,27.47,3,69.84,8
M9A5E8,1739,167,1,16792,27.47,0,69.84,1
M9A1J4,1740,167,5,16797,27.47,1,69.84,3
M9A1K8,1741,167,12,16809,27.47,3,69.84,8
M9A5E9,1742,167,3,16812,27.47,1,69.83,2
M9A1M1,1743,167,14,16826,27.47,4,69.83,10
M9A1K1,1744,167,14,16840,27.47,4,69.83,10
M9B2J9,1745,167,10,16850,26.38,3,74.56,7
M9A1J6,1746,167,8,16858,27.47,2,69.83,6
M9B4Z1,1747,167,5,16863,26.38,1,74.55,4
M9A1K7,1748,167,6,16869,27.47,2,69.83,4
M9A2K6,1749,167,2,16871,27.47,1,69.83,1
M9B2K3,1750,167,2,16873,26.38,1,74.54,1
M3B3G8,1751,167,1,16874,24.09,0,84.45,1
M9A2K9,1752,167,1,16875,27.47,0,69.80,1
L3T1V7,1753,167,11,16886,26.93,3,72.14,8
M9A2K8,1754,167,1,16887,27.47,0,69.80,1
L3T3A3,1755,167,18,16905,26.93,5,72.14,13
M9A5G7,1756,167,1,16906,27.47,0,69.80,1
L3T1V6,1757,167,10,16916,26.93,3,72.14,7
L3T2Z5,1758,167,18,16934,26.93,5,72.13,13
L3T3A1,1759,167,2,16936,26.93,1,72.13,1
L3T1V2,1760,167,15,16951,26.93,4,72.13,11
L3T2Z6,1761,167,8,16959,26.93,2,72.13,6
M3B3G1,1762,167,11,16970,24.09,3,84.39,9
M3B3H8,1763,167,2,16972,24.09,0,84.39,2
M3B3E6,1764,167,16,16988,24.09,4,84.39,14
M3B2B5,1765,167,12,17000,24.09,3,84.39,10
M3B3G3,1766,167,11,17011,24.09,3,84.39,9
M3B3G2,1767,167,19,17030,24.09,5,84.39,16
M3B3G4,1768,167,9,17039,24.09,2,84.38,8
M3B3E7,1769,167,7,17046,24.09,2,84.38,6
M9A2Y3,1770,167,1,17047,28.58,0,64.93,1
M3B3E9,1771,167,10,17057,24.09,2,84.38,8
M3B1T4,1772,167,5,17062,24.09,1,84.38,4
M3B3H5,1773,167,1,17063,26.28,0,74.88,1
M5M3S4,1774,167,12,17075,27.98,3,67.49,8
M5P1Z5,1775,167,1,17076,26.87,0,72.29,1
M5P1X1,1776,167,4,17080,26.87,1,72.28,3
M5P1Y7,1777,167,2,17082,26.87,1,72.28,1
M5P1Y8,1778,167,3,17085,26.87,1,72.27,2
M5N2B3,1779,167,12,17097,26.14,3,75.43,9
M5P1Y5,1780,167,7,17104,26.87,2,72.27,5
M9R1E7,1781,167,5,17109,29.34,1,61.57,3
M5P3G6,1782,167,13,17122,26.87,3,72.27,9
M5P3E6,1783,167,7,17129,26.87,2,72.27,5
M5P1Y6,1784,167,2,17131,26.87,1,72.27,1
M5P3C7,1785,167,8,17139,26.87,2,72.26,6
M5P3E4,1786,167,10,17149,26.87,3,72.26,7
M5P3C5,1787,167,12,17161,26.87,3,72.26,9
M5P3E3,1788,167,12,17173,26.87,3,72.26,9
M5P1Z3,1789,167,4,17177,26.87,1,72.26,3
M5P3G4,1790,167,11,17188,26.87,3,72.26,8
M5P1X3,1791,167,2,17190,26.87,1,72.26,1
M5P1Y4,1792,167,5,17195,26.87,1,72.26,4
M5P3E5,1793,167,11,17206,26.87,3,72.26,8
M5P3G7,1794,167,13,17219,26.87,3,72.26,9
M3B1P2,1795,167,8,17227,26.28,2,74.81,6
M3B2G9,1796,167,6,17233,26.28,2,74.81,4
M3B1R8,1797,167,12,17245,26.28,3,74.81,9
M3B1R7,1798,167,9,17254,26.28,2,74.81,7
M3B2K2,1799,167,16,17270,26.28,4,74.81,12
M3B2G8,1800,167,27,17297,26.28,7,74.81,20
M3B1T9,1801,167,17,17314,26.28,4,74.81,13
M3B2G7,1802,167,10,17324,26.28,3,74.80,7
M3B2J4,1803,167,2,17326,26.28,1,74.80,1
M3B1T6,1804,167,9,17335,26.28,2,74.80,7
M3B2E9,1805,167,12,17347,26.28,3,74.80,9
M3B1P4,1806,167,7,17354,26.28,2,74.80,5
M3B1R9,1807,167,15,17369,26.28,4,74.80,11
M5P1Z6,1808,167,2,17371,26.87,1,72.23,1
M4R2C4,1809,167,9,17380,28.09,3,66.94,6
M5N2C8,1810,167,6,17386,28.09,2,66.94,4
M4R2C3,1811,167,6,17392,28.09,2,66.94,4
M4R1B6,1812,167,20,17412,28.09,6,66.94,13
M4R1B4,1813,167,19,17431,28.09,5,66.93,13
M4R1B8,1814,167,15,17446,28.09,4,66.93,10
M4R1B7,1815,167,17,17463,28.09,5,66.93,11
M4R1B5,1816,167,13,17476,28.09,4,66.93,9
M4R2C2,1817,167,6,17482,28.09,2,66.93,4
M5M4K2,1818,167,1,17483,27.78,0,68.26,1
M5M2Z9,1819,167,2,17485,28.75,1,64.05,1
M5M4J7,1820,167,5,17490,27.78,1,68.23,3
M5M4J6,1821,167,5,17495,27.78,1,68.22,3
M5M2G7,1822,167,8,17503,27.78,2,68.22,5
M5M2M9,1823,167,24,17527,27.78,7,68.22,16
M5M2P7,1824,167,28,17555,27.78,8,68.22,19
M5M2C3,1825,167,16,17571,27.78,4,68.22,11
L4J6Z1,1826,167,10,17581,25.74,3,77.06,8
M5M2L3,1827,167,27,17608,27.78,8,68.22,18
M5M2L4,1828,167,23,17631,27.78,6,68.22,16
M5M2G8,1829,167,13,17644,27.78,4,68.22,9
M5M2N1,1830,167,24,17668,27.78,7,68.22,16
M5M2G6,1831,167,9,17677,27.78,3,68.21,6
M5M2G9,1832,167,8,17685,27.78,2,68.21,5
L4J6Z3,1833,167,10,17695,25.74,3,77.05,8
M5M4J9,1834,167,5,17700,27.78,1,68.20,3
M5M4J8,1835,167,3,17703,27.78,1,68.20,2
M5M4G3,1836,167,3,17706,27.78,1,68.20,2
M5M4K4,1837,167,3,17709,27.78,1,68.20,2
M5M4J5,1838,167,2,17711,27.78,1,68.19,1
M4T2J6,1839,167,9,17720,25.37,2,78.55,7
M4T2K8,1840,167,7,17727,25.37,2,78.55,5
M4T1S9,1841,167,11,17738,25.37,3,78.55,9
M4T1V7,1842,167,8,17746,25.37,2,78.55,6
M4T1V6,1843,167,9,17755,25.37,2,78.55,7
M4T1T4,1844,167,18,17773,25.37,5,78.55,14
M4T1T2,1845,167,8,17781,25.37,2,78.55,6
M4T1V8,1846,167,43,17824,25.37,11,78.55,34
M4T1V3,1847,167,46,17870,25.37,12,78.55,36
M4T2H3,1848,167,8,17878,25.37,2,78.55,6
M4T2K7,1849,167,10,17888,25.37,3,78.55,8
M4T2C8,1850,167,8,17896,25.37,2,78.55,6
M6B1J3,1851,167,10,17906,26.77,3,72.48,7
M4T2J7,1852,167,3,17909,25.37,1,78.54,2
M4T2G5,1853,167,8,17917,25.37,2,78.54,6
M4T1T5,1854,167,3,17920,25.37,1,78.53,2
M6S3V3,1855,167,4,17924,28.50,1,64.97,3
L4J7A9,1856,167,10,17934,26.96,3,71.63,7
M6S3V2,1857,167,6,17940,28.50,2,64.95,4
M6C3J3,1858,167,3,17943,27.07,1,71.15,2
M6C1R8,1859,167,3,17946,27.07,1,71.13,2
M6C3J4,1860,167,7,17953,27.07,2,71.13,5
M6C1V5,1861,167,8,17961,27.07,2,71.13,6
M6C1R5,1862,167,15,17976,27.07,4,71.13,11
M6C1S1,1863,167,8,17984,27.07,2,71.13,6
M6C1W2,1864,167,11,17995,27.07,3,71.13,8
M6C3G2,1865,167,4,17999,27.07,1,71.12,3
M6C1R6,1866,167,18,18017,27.07,5,71.12,13
M6C1R9,1867,167,6,18023,27.07,2,71.12,4
M6C3G1,1868,167,16,18039,27.07,4,71.12,11
M6C1T4,1869,167,5,18044,27.07,1,71.12,4
M6C1R7,1870,167,24,18068,27.07,6,71.12,17
M6C1T9,1871,167,5,18073,27.07,1,71.12,4
M6C1W6,1872,167,4,18077,27.07,1,71.12,3
M6C3G6,1873,167,3,18080,27.07,1,71.12,2
M6C3G5,1874,167,5,18085,27.07,1,71.11,4
M6C1W8,1875,167,6,18091,27.07,2,71.11,4
M6C3C5,1876,167,2,18093,27.69,1,68.42,1
M6C1T3,1877,167,1,18094,27.07,0,71.08,1
M6C1V1,1878,167,1,18095,27.07,0,71.08,1
M2P1T9,1879,167,1,18096,26.26,0,74.58,1
M6C3H4,1880,167,3,18099,27.69,1,68.38,2
M6C2G8,1881,167,8,18107,27.69,2,68.37,5
M6C2G9,1882,167,14,18121,27.69,4,68.37,10
M6C2G2,1883,167,15,18136,27.69,4,68.37,10
M6C2G1,1884,167,15,18151,27.69,4,68.37,10
M6C3C7,1885,167,4,18155,27.69,1,68.37,3
M6C2E9,1886,167,7,18162,27.69,2,68.36,5
M6C3C6,1887,167,3,18165,27.69,1,68.36,2
M6C2E8,1888,167,9,18174,27.69,2,68.36,6
M6C3C8,1889,167,4,18178,27.69,1,68.34,3
M5M1M5,1890,167,44,18222,26.92,12,71.66,32
M5M1P4,1891,167,45,18267,26.92,12,71.66,32
M4N1V8,1892,167,11,18278,27.67,3,68.37,8
M4N2R9,1893,167,7,18285,27.67,2,68.36,5
M4N1W1,1894,167,5,18290,27.67,1,68.36,3
M4N1S4,1895,167,9,18299,27.67,2,68.36,6
M4N2S2,1896,167,17,18316,27.67,5,68.36,12
M4N1S7,1897,167,10,18326,27.67,3,68.35,7
M4N2S1,1898,167,11,18337,27.67,3,68.35,8
M4N1S3,1899,167,12,18349,27.67,3,68.35,8
M4N2V1,1900,167,14,18363,27.67,4,68.35,10
M4N1W3,1901,167,7,18370,27.67,2,68.35,5
M4N1V7,1902,167,14,18384,27.67,4,68.35,10
M4N2V2,1903,167,14,18398,27.67,4,68.35,10
M4N1S6,1904,167,7,18405,27.67,2,68.35,5
M5M3N7,1905,167,4,18409,27.93,1,67.22,3
M4N1Y7,1906,167,34,18443,28.36,10,65.30,22
M4N1X4,1907,167,30,18473,28.36,9,65.30,20
M4N2Y3,1908,167,4,18477,28.36,1,65.30,3
L4J6Z4,1909,167,16,18493,25.64,4,77.05,12
L3T5M7,1910,167,31,18524,27.49,9,69.01,21
L3T5M4,1911,167,31,18555,27.49,9,69.01,21
L3T5J4,1912,167,20,18575,27.49,5,69.00,14
L3T5M5,1913,167,5,18580,27.49,1,69.00,3
M8Z6C9,1914,167,15,18595,25.93,4,75.76,11
L3T5J2,1915,167,11,18606,27.49,3,69.00,8
L3T5M3,1916,167,17,18623,27.49,5,69.00,12
M5M1W6,1917,167,16,18639,27.12,4,70.59,11
M5M1T3,1918,167,19,18658,27.12,5,70.58,13
M4N2Y8,1919,166,3,18661,25.12,1,79.21,2
M4N2W2,1920,166,1,18662,25.12,0,79.20,1
M4N3C6,1921,166,12,18674,25.12,3,79.20,10
M4N2C8,1922,166,7,18681,25.12,2,79.19,6
M4N2B9,1923,166,25,18706,25.12,6,79.19,20
M4N2V9,1924,166,1,18707,25.12,0,79.19,1
M4N2B2,1925,166,26,18733,25.12,7,79.19,21
M4N2C2,1926,166,10,18743,25.12,3,79.19,8
M4N3C7,1927,166,5,18748,25.12,1,79.19,4
M4N2A2,1928,166,29,18777,25.12,7,79.19,23
M4N2C7,1929,166,17,18794,25.12,4,79.19,13
M4W2Y4,1930,166,5,18799,22.22,1,91.75,5
M4N2C1,1931,166,16,18815,25.12,4,79.18,13
M4N2B3,1932,166,15,18830,25.12,4,79.18,12
M9P2A9,1933,166,1,18831,28.13,0,66.14,1
M9P3T9,1934,166,79,18910,28.13,22,66.14,52
M6B3E6,1935,166,2,18912,26.58,1,72.83,1
M4N3C5,1936,166,1,18913,25.12,0,79.13,1
M4N2V5,1937,166,3,18916,28.37,1,65.05,2
M5M1N3,1938,166,11,18927,28.39,3,64.95,7
M4W2A4,1939,166,9,18936,23.39,2,86.60,8
M5M1N2,1940,166,11,18947,28.38,3,64.94,7
L4J4V3,1941,166,10,18957,27.81,3,67.41,7
L4J4V6,1942,166,15,18972,27.81,4,67.41,10
L4J4V1,1943,166,11,18983,27.81,3,67.41,7
L4J8B1,1944,166,28,19011,27.98,8,66.66,19
L4J7W4,1945,166,46,19057,27.98,13,66.66,31
L4J8B3,1946,166,39,19096,27.98,11,66.66,26
M6H3K2,1947,166,24,19120,26.06,6,74.97,18
M4N0A4,1948,166,126,19246,24.13,30,83.22,105
M4G4H5,1949,166,5,19251,27.43,1,68.91,3
M2J1G4,1950,166,13,19264,26.97,4,70.90,9
M2J1C2,1951,166,9,19273,26.97,2,70.90,6
M2J1C6,1952,166,11,19284,26.97,3,70.90,8
M2J1B9,1953,166,16,19300,26.97,4,70.90,11
M2J1C1,1954,166,14,19314,26.97,4,70.90,10
M2J1G5,1955,166,22,19336,26.97,6,70.89,16
M2J1B8,1956,166,30,19366,26.97,8,70.89,21
M2J1H4,1957,166,10,19376,26.97,3,70.89,7
M2J1H6,1958,166,2,19378,26.97,1,70.89,1
M2J1B2,1959,166,9,19387,26.97,2,70.89,6
M2J1B7,1960,166,15,19402,26.97,4,70.89,11
M2J1G1,1961,166,5,19407,26.97,1,70.88,4
M6B4E9,1962,166,1,19408,28.29,0,65.15,1
M5N2E8,1963,166,21,19429,27.79,6,67.32,14
M5N1L5,1964,166,42,19471,27.79,12,67.31,28
M5N1M8,1965,166,48,19519,27.79,13,67.31,32
M5N1M2,1966,166,44,19563,27.79,12,67.31,30
M2J1B1,1967,166,4,19567,26.95,1,70.91,3
M5M1K5,1968,166,27,19594,26.60,7,72.38,20
M5M1H9,1969,166,10,19604,26.60,3,72.38,7
L4J7T8,1970,166,37,19641,28.43,11,64.45,24
M5M4H7,1971,166,1,19642,26.66,0,72.08,1
M5M1R8,1972,166,19,19661,26.67,5,72.04,14
M5M1L9,1973,166,31,19692,26.67,8,72.04,22
M5M1V3,1974,166,21,19713,26.67,6,72.04,15
M5M4H9,1975,166,6,19719,26.67,2,72.03,4
M5M4E3,1976,166,3,19722,26.67,1,72.02,2
M9A1R9,1977,166,5,19727,26.89,1,71.06,4
M5M4E2,1978,166,4,19731,26.66,1,72.05,3
M5M1S1,1979,166,20,19751,26.66,5,72.04,14
M5M1R9,1980,166,21,19772,26.66,6,72.04,15
M5M1N8,1981,166,18,19790,26.66,5,72.04,13
M5M1N7,1982,166,22,19812,26.66,6,72.04,16
M5M1N6,1983,166,23,19835,26.66,6,72.04,17
M5N1Z7,1984,166,4,19839,25.87,1,75.45,3
M5N1W9,1985,166,6,19845,25.87,2,75.45,5
M5N1W6,1986,166,4,19849,25.87,1,75.45,3
M5M4H5,1987,166,1,19850,26.67,0,71.98,1
M5N2S9,1988,166,4,19854,25.87,1,75.44,3
M5N2T1,1989,166,5,19859,25.87,1,75.44,4
M5N2V2,1990,166,3,19862,25.87,1,75.44,2
M5N1Z6,1991,166,4,19866,25.87,1,75.44,3
M5N1Y4,1992,166,5,19871,25.87,1,75.44,4
M9A3J4,1993,166,10,19881,26.30,3,73.57,7
M5N2C1,1994,166,11,19892,25.87,3,75.43,8
M5N1Z1,1995,166,14,19906,25.87,4,75.43,11
M5N2T6,1996,166,3,19909,25.87,1,75.43,2
M5N1Y9,1997,166,10,19919,25.87,3,75.43,8
M5N1Y3,1998,166,7,19926,25.87,2,75.43,5
L3T4H5,1999,166,24,19950,27.50,7,68.37,16
M5N2T4,2000,166,5,19955,25.87,1,75.43,4
M8Y3X7,2001,166,2,19957,27.65,1,67.69,1
M5P1H7,2002,166,7,19964,27.47,2,68.47,5
M5P2H7,2003,166,14,19978,27.47,4,68.47,10
M5P1H8,2004,166,4,19982,27.47,1,68.47,3
M4R1W7,2005,166,4,19986,24.12,1,82.98,3
M5P2E6,2006,166,17,20003,27.47,5,68.46,12
M5P2G3,2007,166,11,20014,27.47,3,68.46,8
M5P1G7,2008,166,6,20020,27.47,2,68.46,4
M5P1H9,2009,166,5,20025,27.47,1,68.46,3
M8Y4G2,2010,166,1,20026,27.65,0,67.68,1
M8Y2K1,2011,166,16,20042,27.65,4,67.67,11
M8Y2L3,2012,166,53,20095,27.65,15,67.67,36
M8Y2L2,2013,166,18,20113,27.65,5,67.67,12
M8Y3X4,2014,166,6,20119,27.65,2,67.66,4
M8Y2L6,2015,166,1,20120,27.64,0,67.68,1
M8Y4A4,2016,166,3,20123,27.65,1,67.63,2
M8X1A2,2017,166,35,20158,27.64,10,67.67,24
M4S1J9,2018,166,21,20179,26.56,6,72.32,15
M8Y4G3,2019,166,1,20180,27.64,0,67.64,1
L3T1G2,2020,166,9,20189,26.98,2,70.43,6
M4R1V9,2021,166,3,20192,26.44,1,72.74,2
M4R2A5,2022,166,9,20201,26.44,2,72.73,7
M4R1J6,2023,166,47,20248,26.44,12,72.73,34
M4R1H9,2024,166,37,20285,26.44,10,72.73,27
M4R1K1,2025,166,45,20330,26.44,12,72.73,33
M4R1J7,2026,166,47,20377,26.44,12,72.73,34
M9A3T5,2027,166,18,20395,29.06,5,61.37,11
M4R2H3,2028,166,1,20396,26.44,0,72.70,1
M5R2Y5,2029,166,1,20397,25.39,0,77.23,1
M5P2V1,2030,166,12,20409,23.74,3,84.37,10
M5P2X1,2031,166,11,20420,23.74,3,84.37,9
M5P2T8,2032,166,8,20428,23.74,2,84.37,7
M5P1M6,2033,166,5,20433,23.74,1,84.36,4
M5P1L4,2034,166,7,20440,23.73,2,84.39,6
M5P2T4,2035,166,6,20446,23.73,1,84.38,5
M5P2S3,2036,166,7,20453,23.73,2,84.38,6
M5P2S5,2037,166,11,20464,23.73,3,84.38,9
M5P2T5,2038,166,9,20473,23.73,2,84.37,8
M5P2T7,2039,166,14,20487,23.73,3,84.37,12
M5P2T9,2040,166,10,20497,23.73,2,84.37,8
M5P2P9,2041,166,7,20504,23.73,2,84.37,6
M5P2R2,2042,166,4,20508,23.73,1,84.37,3
M5P2R1,2043,166,5,20513,23.73,1,84.37,4
M5P2R4,2044,166,2,20515,23.73,0,84.37,2
M5P1L2,2045,166,1,20516,23.74,0,84.32,1
M5R1Z8,2046,166,10,20526,25.39,3,77.11,8
M5R3A1,2047,166,19,20545,25.39,5,77.11,15
L3T5M6,2048,166,22,20567,27.34,6,68.61,15
M5M3N6,2049,166,2,20569,27.65,1,67.24,1
M5M3T9,2050,166,4,20573,27.65,1,67.23,3
M5M1P7,2051,166,19,20592,27.65,5,67.23,13
M5M1W4,2052,166,31,20623,27.65,9,67.23,21
M5M1T2,2053,166,21,20644,27.65,6,67.23,14
M5M1W3,2054,166,39,20683,27.65,11,67.23,26
M5M1T1,2055,166,36,20719,27.65,10,67.23,24
M5M3V3,2056,166,4,20723,27.65,1,67.23,3
M5M3T7,2057,166,3,20726,27.64,1,67.26,2
M5M3T5,2058,166,3,20729,25.58,1,76.16,2
M8Y4B3,2059,166,3,20732,29.37,1,59.74,2
M8Y3W3,2060,166,8,20740,29.37,2,59.74,5
M5M3N3,2061,166,3,20743,25.58,1,76.16,2
M8Y2E5,2062,166,15,20758,29.37,4,59.74,9
M8Y2E6,2063,166,14,20772,29.37,4,59.74,8
M8Y1Z6,2064,166,16,20788,29.37,5,59.73,10
M8Y2G4,2065,166,21,20809,29.37,6,59.73,13
M5M1L3,2066,166,19,20828,25.58,5,76.15,14
M5M1J5,2067,166,22,20850,25.58,6,76.15,17
M5M1J6,2068,166,23,20873,25.58,6,76.15,18
M5M1G8,2069,166,17,20890,25.58,4,76.15,13
M5M1J4,2070,166,38,20928,25.58,10,76.15,29
M5M1J3,2071,166,44,20972,25.58,11,76.15,34
M5M1G6,2072,166,41,21013,25.58,10,76.15,31
M5M1L1,2073,166,46,21059,25.58,12,76.15,35
M5M3T6,2074,166,1,21060,25.58,0,76.14,1
L4J7K6,2075,166,11,21071,26.79,3,70.89,8
M5M3T4,2076,166,4,21075,25.58,1,76.14,3
M6B2T6,2077,166,5,21080,26.97,1,70.11,4
M6B2W7,2078,166,7,21087,26.97,2,70.11,5
M8Y3W4,2079,166,5,21092,29.37,1,59.71,3
M5M3V9,2080,165,5,21097,26.45,1,72.33,4
M6B4J6,2081,165,26,21123,27.29,7,68.67,18
M9B3G2,2082,165,2,21125,28.21,1,64.67,1
M9B3E9,2083,165,2,21127,28.21,1,64.67,1
M9B5K7,2084,165,2,21129,28.21,1,64.67,1
M9B3G3,2085,165,3,21132,28.21,1,64.66,2
M9B5Z8,2086,165,9,21141,28.21,3,64.66,6
M9B5K5,2087,165,7,21148,28.21,2,64.66,5
M9B3H2,2088,165,13,21161,28.21,4,64.66,8
M9B3H1,2089,165,8,21169,28.21,2,64.66,5
M9B6A2,2090,165,16,21185,28.21,5,64.66,10
M9B5Z2,2091,165,19,21204,28.21,5,64.65,12
M9B6A3,2092,165,8,21212,28.21,2,64.65,5
M9B3G6,2093,165,10,21222,28.21,3,64.65,6
M9B5Z9,2094,165,10,21232,28.21,3,64.65,6
M5P1K8,2095,165,3,21235,23.53,1,84.92,3
M9B5K4,2096,165,7,21242,28.21,2,64.65,5
M9B5K6,2097,165,7,21249,28.21,2,64.65,5
M5N2Y1,2098,165,9,21258,27.35,2,68.36,6
M5N2Y5,2099,165,7,21265,27.35,2,68.35,5
M5N1Y8,2100,165,12,21277,27.35,3,68.35,8
M5N2W7,2101,165,12,21289,27.35,3,68.35,8
M5N2B1,2102,165,12,21301,27.35,3,68.35,8
M5N1Y7,2103,165,15,21316,27.35,4,68.35,10
M5N2W6,2104,165,1,21317,27.35,0,68.35,1
M5N3A4,2105,165,1,21318,27.35,0,68.35,1
M5N2A7,2106,165,2,21320,27.35,1,68.35,1
M5N1Z4,2107,165,13,21333,27.35,4,68.35,9
M5N2W5,2108,165,18,21351,27.35,5,68.35,12
M8X2A9,2109,165,2,21353,28.54,1,63.19,1
M5N1Z5,2110,165,11,21364,27.35,3,68.35,8
M5N2Y4,2111,165,3,21367,27.35,1,68.34,2
M8Y4A9,2112,165,4,21371,27.16,1,69.16,3
M8X1Z7,2113,165,4,21375,28.54,1,63.18,3
M8Y3Z6,2114,165,3,21378,27.16,1,69.16,2
M8X1Z4,2115,165,9,21387,28.54,3,63.18,6
M8Y3Z8,2116,165,3,21390,27.16,1,69.15,2
M8Y2G6,2117,165,11,21401,27.16,3,69.15,8
M8X1M7,2118,165,16,21417,28.54,5,63.17,10
M8X1J7,2119,165,9,21426,28.54,3,63.17,6
M8X1J8,2120,165,6,21432,28.54,2,63.17,4
M8X1K5,2121,165,10,21442,28.54,3,63.17,6
M8X1Z6,2122,165,7,21449,28.54,2,63.17,4
M8X1K4,2123,165,14,21463,28.54,4,63.17,9
M8Y2A9,2124,165,8,21471,27.16,2,69.15,6
M5N2A6,2125,165,3,21474,27.35,1,68.32,2
M8X1Z8,2126,165,2,21476,28.54,1,63.17,1
M5M1K7,2127,165,41,21517,26.58,11,71.66,29
M8Y2A2,2128,165,9,21526,27.16,2,69.14,6
M8Y2A3,2129,165,9,21535,27.16,2,69.14,6
M2K1G2,2130,165,9,21544,25.52,2,76.24,7
M8Y4A8,2131,165,2,21546,27.16,1,69.13,1
M5M1Y7,2132,165,45,21591,27.78,13,66.40,30
M9B4P3,2133,165,2,21593,28.13,1,64.88,1
M9B4P4,2134,165,8,21601,28.13,2,64.87,5
M9B4P5,2135,165,8,21609,28.13,2,64.87,5
M9B4P6,2136,165,17,21626,28.13,5,64.87,11
M9B2A5,2137,165,13,21639,28.13,4,64.86,8
M9B4P9,2138,165,19,21658,28.13,5,64.86,12
M5M1W8,2139,165,10,21668,28.11,3,64.95,6
M4S2L4,2140,165,9,21677,27.38,2,68.05,6
M4S1R7,2141,165,10,21687,27.38,3,68.05,7
M4S1T7,2142,165,23,21710,27.38,6,68.04,16
M4S1R6,2143,165,23,21733,27.38,6,68.04,16
M8X2Y8,2144,165,7,21740,26.34,2,72.48,5
M9B2B6,2145,165,5,21745,28.11,1,64.81,3
M9B4R1,2146,165,26,21771,28.11,7,64.81,17
M9B5B2,2147,165,11,21782,28.11,3,64.78,7
M9A1X4,2148,165,8,21790,27.38,2,67.91,5
M9A1W7,2149,165,8,21798,27.38,2,67.91,5
M9A2P3,2150,165,12,21810,27.38,3,67.91,8
M9A3M6,2151,165,14,21824,27.38,4,67.90,10
M9A2N1,2152,165,15,21839,27.38,4,67.90,10
M9A2P1,2153,165,10,21849,27.38,3,67.90,7
M9A2N9,2154,165,21,21870,27.38,6,67.90,14
M9A1X9,2155,165,10,21880,27.38,3,67.90,7
M9A2P5,2156,165,2,21882,27.38,1,67.90,1
M9A2N8,2157,165,5,21887,27.38,1,67.90,3
M9A1X2,2158,165,8,21895,27.38,2,67.90,5
M9A1X3,2159,165,8,21903,27.38,2,67.90,5
M9A1V6,2160,165,1,21904,27.38,0,67.90,1
M9A1X1,2161,165,6,21910,27.38,2,67.90,4
M9A2P2,2162,165,2,21912,27.38,1,67.89,1
M9A1X7,2163,165,3,21915,27.38,1,67.89,2
M9A2P4,2164,165,2,21917,27.38,1,67.89,1
M9A1V9,2165,165,2,21919,27.38,1,67.89,1
M5M1K6,2166,165,29,21948,26.34,8,72.38,21
M5M1M4,2167,165,32,21980,26.34,8,72.38,23
M6B4J7,2168,165,1,21981,26.86,0,70.12,1
M9A1Y3,2169,165,1,21982,27.38,0,67.84,1
M2N4X8,2170,165,2,21984,27.07,1,69.18,1
M9A4P7,2171,165,2,21986,26.21,1,72.91,1
M5M1M3,2172,165,30,22016,26.33,8,72.38,22
M2N4X1,2173,165,3,22019,27.07,1,69.17,2
M9A4G3,2174,165,7,22026,26.21,2,72.89,5
M4N1W2,2175,165,29,22055,27.69,8,66.48,19
M9A4P4,2176,165,5,22060,26.21,1,72.89,4
M9A4G7,2177,165,11,22071,26.21,3,72.89,8
M9A4P6,2178,165,31,22102,26.21,8,72.89,23
M9A4P8,2179,165,5,22107,26.21,1,72.89,4
M9A4G5,2180,165,18,22125,26.21,5,72.89,13
M2N2X3,2181,165,12,22137,27.07,3,69.16,8
M9A4P5,2182,165,40,22177,26.21,10,72.89,29
M2N2Y2,2183,165,11,22188,27.07,3,69.16,8
M9A3G6,2184,165,4,22192,26.21,1,72.88,3
M9A4G4,2185,165,7,22199,26.21,2,72.88,5
M2N2V5,2186,165,16,22215,27.07,4,69.15,11
M9A4G2,2187,165,5,22220,26.21,1,72.88,4
M2N2Y3,2188,165,14,22234,27.07,4,69.15,10
M9A4C3,2189,165,1,22235,26.21,0,72.88,1
M2N2W4,2190,165,2,22237,27.07,1,69.15,1
M2N2X6,2191,165,2,22239,27.07,1,69.15,1
M2N2X4,2192,165,9,22248,27.07,2,69.15,6
M2N4W8,2193,165,11,22259,27.07,3,69.15,8
M4R1X1,2194,165,1,22260,26.28,0,72.56,1
M4R1N5,2195,165,15,22275,26.29,4,72.51,11
M4R1P5,2196,165,12,22287,26.29,3,72.51,9
M4R1N4,2197,165,14,22301,26.29,4,72.51,10
M4R1P6,2198,165,16,22317,26.29,4,72.51,12
M2N4W9,2199,165,2,22319,27.07,1,69.12,1
M4R1W8,2200,165,2,22321,26.28,1,72.52,1
M5M3K8,2201,165,4,22325,27.61,1,66.75,3
M5M3N9,2202,165,4,22329,27.61,1,66.74,3
M4R1R6,2203,165,3,22332,26.28,1,72.50,2
L3T4L4,2204,165,3,22335,27.23,1,68.38,2
L3T4V3,2205,165,10,22345,27.23,3,68.38,7
L3T4L5,2206,165,9,22354,27.23,2,68.37,6
L3T4H4,2207,165,17,22371,27.23,5,68.37,12
L3T4G2,2208,165,7,22378,27.23,2,68.37,5
L3T4J7,2209,165,1,22379,27.23,0,68.37,1
L4J7V2,2210,165,28,22407,26.49,7,71.57,20
L3T4V4,2211,165,10,22417,27.23,3,68.37,7
M9A2R9,2212,165,11,22428,27.31,3,68.01,7
M5M1Y8,2213,165,36,22464,27.60,10,66.74,24
M5M1W1,2214,165,44,22508,27.60,12,66.74,29
M5M3N8,2215,165,5,22513,27.60,1,66.74,3
M5P2G4,2216,165,11,22524,27.20,3,68.47,8
M5M3K6,2217,165,7,22531,27.60,2,66.73,5
M5P1G5,2218,165,8,22539,27.20,2,68.47,5
M5P1H6,2219,165,8,22547,27.20,2,68.46,5
M5P2E4,2220,165,11,22558,27.20,3,68.46,8
M9B2X7,2221,165,2,22560,28.55,1,62.60,1
M2N6H6,2222,165,4,22564,27.69,1,66.32,3
M9B5H2,2223,165,2,22566,28.55,1,62.59,1
M6J1B2,2224,165,25,22591,25.25,6,76.88,19
M9B5J6,2225,165,2,22593,28.55,1,62.58,1
M6J1A2,2226,165,17,22610,25.25,4,76.87,13
M6J1A1,2227,165,18,22628,25.25,5,76.87,14
M9B2X9,2228,165,9,22637,28.55,3,62.57,6
M9B5J5,2229,165,3,22640,28.55,1,62.57,2
M9B2Y8,2230,165,10,22650,28.55,3,62.57,6
M9B3N9,2231,165,1,22651,28.55,0,62.57,1
M9B2Y6,2232,165,3,22654,28.55,1,62.56,2
M9B2Z2,2233,165,17,22671,28.55,5,62.56,11
M9B2X8,2234,165,18,22689,28.55,5,62.56,11
M9B2Y4,2235,165,27,22716,28.55,8,62.56,17
M9B2V8,2236,165,5,22721,28.55,1,62.56,3
M9B2Y5,2237,165,18,22739,28.55,5,62.56,11
M9B2V7,2238,165,12,22751,28.55,3,62.56,8
M9B2Y7,2239,165,12,22763,28.55,3,62.55,8
M9B5H4,2240,165,3,22766,28.55,1,62.55,2
M9B2Y1,2241,165,5,22771,28.55,1,62.55,3
M9B5H3,2242,165,2,22773,28.55,1,62.54,1
M2N1W3,2243,165,11,22784,27.59,3,66.68,7
M2N1W2,2244,165,6,22790,27.59,2,66.67,4
M2N2M9,2245,165,7,22797,27.59,2,66.67,5
M2N2M8,2246,165,9,22806,27.59,2,66.67,6
M9B3P1,2247,165,1,22807,28.55,0,62.51,1
M9B2Z1,2248,165,1,22808,28.55,0,62.51,1
M2N1W4,2249,165,12,22820,27.59,3,66.67,8
M2N1T9,2250,165,7,22827,27.59,2,66.67,5
M2N1T6,2251,165,14,22841,27.59,4,66.66,9
M5P2P8,2252,165,9,22850,23.14,2,85.92,8
L4J7M9,2253,165,18,22868,27.90,5,65.25,12
M9A1V8,2254,165,1,22869,26.83,0,69.89,1
L4J7M6,2255,165,17,22886,27.90,5,65.25,11
L4J7M5,2256,165,10,22896,27.90,3,65.24,7
M9A2Y1,2257,165,6,22902,27.95,2,65.01,4
M9A2W7,2258,165,3,22905,27.95,1,65.00,2
M9A2X8,2259,165,1,22906,27.95,0,65.00,1
M9A3T3,2260,165,5,22911,27.95,1,65.00,3
M9A3R4,2261,165,7,22918,27.95,2,65.00,5
M9A2W5,2262,165,21,22939,27.95,6,65.00,14
M9A2W6,2263,165,30,22969,27.95,8,64.99,19
M9A2X4,2264,165,13,22982,27.95,4,64.99,8
M9A3P6,2265,165,18,23000,27.95,5,64.99,12
M9A2W9,2266,165,29,23029,27.95,8,64.99,19
M9A3K5,2267,165,17,23046,27.95,5,64.99,11
M9A1A6,2268,165,13,23059,27.95,4,64.99,8
M9A2W4,2269,165,28,23087,27.95,8,64.99,18
M9A2X1,2270,165,23,23110,27.95,6,64.99,15
M9A2W8,2271,165,23,23133,27.95,6,64.99,15
M9A3P7,2272,165,4,23137,27.95,1,64.99,3
M9A3R7,2273,165,7,23144,27.95,2,64.99,5
M9A3P9,2274,165,5,23149,27.95,1,64.99,3
M9A3P8,2275,165,4,23153,27.95,1,64.99,3
M9A2X9,2276,165,7,23160,27.95,2,64.99,5
M9A3R8,2277,165,11,23171,27.95,3,64.99,7
M9A3K3,2278,165,6,23177,27.95,2,64.98,4
M9A2M7,2279,165,17,23194,26.80,5,69.97,12
M9A3R5,2280,165,8,23202,27.95,2,64.98,5
M9A3R6,2281,165,3,23205,27.95,1,64.98,2
M9P3N2,2282,165,1,23206,27.30,0,67.80,1
M9A3T1,2283,165,2,23208,27.95,1,64.98,1
M9A1S5,2284,165,1,23209,26.75,0,70.18,1
M6J3T6,2285,165,8,23217,27.75,2,65.82,5
M6J3T7,2286,165,10,23227,27.75,3,65.82,7
M6J3T8,2287,165,23,23250,27.75,6,65.82,15
M9A3R9,2288,165,1,23251,27.95,0,64.94,1
M9A1T8,2289,165,11,23262,26.75,3,70.14,8
M9A1R8,2290,165,12,23274,26.75,3,70.14,8
M9A1T3,2291,165,8,23282,26.75,2,70.14,6
M9A1T2,2292,165,12,23294,26.75,3,70.14,8
M9A1P9,2293,165,8,23302,26.75,2,70.13,6
M9A1T6,2294,165,12,23314,26.75,3,70.13,8
M9A2M5,2295,165,11,23325,26.75,3,70.13,8
M3B1H2,2296,165,2,23327,25.02,1,77.63,2
M9A1S1,2297,165,4,23331,26.75,1,70.13,3
M9A1T1,2298,165,5,23336,26.75,1,70.13,4
M9A2M8,2299,165,12,23348,26.75,3,70.13,8
M9A1R5,2300,165,5,23353,26.75,1,70.13,4
M9B0C1,2301,165,8,23361,31.23,2,50.71,4
M3B1H3,2302,165,2,23363,25.02,1,77.62,2
M3B3P2,2303,165,1,23364,25.02,0,77.61,1
M9A1T7,2304,165,2,23366,26.75,1,70.12,1
M3B3N5,2305,165,1,23367,25.02,0,77.61,1
M3B3P7,2306,165,1,23368,25.02,0,77.61,1
M9A1S2,2307,165,2,23370,26.75,1,70.10,1
M3B2K8,2308,165,4,23374,25.02,1,77.60,3
M3B1E5,2309,165,7,23381,25.02,2,77.60,5
M3B1J3,2310,165,7,23388,25.02,2,77.60,5
M3B2K9,2311,165,11,23399,25.02,3,77.59,9
M3B1E6,2312,165,2,23401,25.02,1,77.59,2
M3B2G1,2313,165,11,23412,25.02,3,77.59,9
M3B2H7,2314,165,4,23416,25.02,1,77.59,3
M3B1E3,2315,165,15,23431,25.02,4,77.59,12
M3B2G2,2316,165,11,23442,25.02,3,77.59,9
M3B2G3,2317,165,8,23450,25.02,2,77.59,6
M3B2E1,2318,165,11,23461,25.02,3,77.59,9
M3B2E2,2319,165,3,23464,25.02,1,77.59,2
M3B2K4,2320,165,8,23472,25.02,2,77.59,6
M3B2G4,2321,165,11,23483,25.02,3,77.59,9
M3B1E8,2322,165,9,23492,25.02,2,77.59,7
M3B1E4,2323,165,5,23497,25.02,1,77.59,4
M3B2L1,2324,165,5,23502,25.02,1,77.59,4
M3B2E3,2325,165,3,23505,25.02,1,77.58,2
M4W2Y3,2326,165,4,23509,23.29,1,85.07,3
L4J7S6,2327,165,32,23541,26.77,9,69.97,22
M3B1E9,2328,165,1,23542,25.02,0,77.54,1
M9A4C4,2329,165,4,23546,26.29,1,72.00,3
L4J7T9,2330,165,39,23585,27.79,11,65.40,26
M4R2C7,2331,164,2,23587,26.72,1,70.01,1
M5N2Z1,2332,164,1,23588,25.47,0,75.42,1
M4R2A4,2333,164,8,23596,26.72,2,69.99,6
M4R1K6,2334,164,25,23621,26.72,7,69.99,17
M4R1L6,2335,164,24,23645,26.72,6,69.99,17
M4R1K4,2336,164,11,23656,26.72,3,69.99,8
M4R1K7,2337,164,11,23667,26.72,3,69.99,8
M4R1J2,2338,164,51,23718,26.72,14,69.98,36
M4R1K5,2339,164,11,23729,26.72,3,69.98,8
M4R1K3,2340,164,11,23740,26.72,3,69.98,8
M4R2A6,2341,164,7,23747,26.72,2,69.97,5
M4R2C6,2342,164,4,23751,26.72,1,69.97,3
M4N2A8,2343,164,24,23775,26.53,6,70.80,17
M9A4G6,2344,164,12,23787,26.32,3,71.71,9
M4N1Z2,2345,164,29,23816,26.53,8,70.80,21
M4N1Z9,2346,164,26,23842,26.53,7,70.79,18
M6B1L3,2347,164,48,23890,26.24,13,72.03,35
M4T1C6,2348,164,27,23917,21.87,6,90.95,25
M5P2S2,2349,164,1,23918,23.02,0,85.95,1
M5P2S8,2350,164,3,23921,23.02,1,85.93,3
M5P2S6,2351,164,3,23924,23.02,1,85.92,3
M5P1M4,2352,164,16,23940,23.02,4,85.92,14
M5P1M5,2353,164,9,23949,23.02,2,85.92,8
M5P2P2,2354,164,24,23973,23.02,6,85.92,21
M5P2P7,2355,164,7,23980,23.02,2,85.92,6
M5P2N4,2356,164,22,24002,23.02,5,85.92,19
M5P2P1,2357,164,14,24016,23.02,3,85.92,12
L4J7K7,2358,164,16,24032,26.63,4,70.26,11
M2L0A1,2359,164,1,24033,26.19,0,72.16,1
M5P3N4,2360,164,1,24034,23.02,0,85.89,1
M8X2B8,2361,164,5,24039,28.26,1,63.19,3
M8X1J3,2362,164,12,24051,28.26,3,63.18,8
M5P2S4,2363,164,7,24058,23.01,2,85.92,6
M5P1K9,2364,164,2,24060,23.57,0,83.50,2
M8X1H8,2365,164,11,24071,28.26,3,63.18,7
M8X1H4,2366,164,12,24083,28.26,3,63.18,8
M5P2P6,2367,164,11,24094,23.01,3,85.92,9
M8X1J1,2368,164,6,24100,28.26,2,63.17,4
M8X1H6,2369,164,5,24105,28.26,1,63.17,3
M8X1Z5,2370,164,4,24109,28.26,1,63.17,3
M8X2E9,2371,164,5,24114,28.26,1,63.17,3
M8X1H5,2372,164,6,24120,28.26,2,63.17,4
M8X2C1,2373,164,2,24122,28.26,1,63.17,1
M8X1H9,2374,164,11,24133,28.26,3,63.17,7
M8X1J6,2375,164,9,24142,28.26,3,63.17,6
M8X2B7,2376,164,6,24148,28.26,2,63.17,4
M8X2E7,2377,164,5,24153,28.26,1,63.17,3
M5P1M3,2378,164,6,24159,23.01,1,85.91,5
M8X1J2,2379,164,8,24167,28.26,2,63.17,5
M5P2N9,2380,164,3,24170,23.01,1,85.91,3
M8X2B9,2381,164,2,24172,28.26,1,63.15,1
M9R2V4,2382,164,4,24176,28.51,1,62.06,2
M9R2P8,2383,164,14,24190,28.51,4,62.05,9
M9R2W6,2384,164,39,24229,28.51,11,62.05,24
M9R2W4,2385,164,26,24255,28.51,7,62.05,16
M5P1L1,2386,164,3,24258,23.57,1,83.44,3
M6P3G6,2387,164,24,24282,25.98,6,73.00,18
M6P2W1,2388,164,9,24291,25.98,2,73.00,7
M6P1G5,2389,164,25,24316,25.98,6,72.99,18
M6P2W7,2390,164,21,24337,25.98,5,72.99,15
M2K2G5,2391,164,4,24341,25.23,1,76.23,3
M6B2N2,2392,164,8,24349,26.64,2,70.11,6
M9R2V8,2393,164,2,24351,28.50,1,62.04,1
M9B1Z7,2394,164,6,24357,27.28,2,67.30,4
M9B4Z8,2395,164,9,24366,27.28,2,67.30,6
M5M1M8,2396,164,38,24404,26.20,10,71.97,27
M9B1Z9,2397,164,2,24406,27.28,1,67.28,1
M4N1X3,2398,164,33,24439,27.73,9,65.30,22
M4N2Y1,2399,164,4,24443,27.73,1,65.29,3
M9A3W8,2400,164,7,24450,29.01,2,59.73,4
M9A3W7,2401,164,9,24459,29.01,3,59.73,5
M9A3W9,2402,164,14,24473,29.01,4,59.73,8
M5M2M4,2403,164,11,24484,27.97,3,64.22,7
M5M3W4,2404,164,9,24493,27.97,3,64.22,6
M2R1B2,2405,164,1,24494,27.02,0,68.33,1
M4V1X1,2406,164,2,24496,25.92,1,73.08,1
M4V2R1,2407,164,7,24503,25.92,2,73.08,5
M8Y2V2,2408,164,1,24504,28.16,0,63.32,1
M8Z3T6,2409,164,1,24505,28.16,0,63.30,1
M4P2L9,2410,164,12,24517,26.26,3,71.53,9
M4P2M8,2411,164,3,24520,26.26,1,71.53,2
M4P2A5,2412,164,59,24579,26.26,15,71.52,42
M4P2M5,2413,164,7,24586,26.26,2,71.52,5
M4P2A9,2414,164,25,24611,26.26,7,71.52,18
M4P2B8,2415,164,6,24617,26.26,2,71.52,4
M4P2B7,2416,164,30,24647,26.26,8,71.52,21
M4W1M3,2417,164,14,24661,23.69,3,82.65,12
M4W1J8,2418,164,9,24670,23.69,2,82.64,7
M4W1M2,2419,164,21,24691,23.69,5,82.64,17
L4J8K7,2420,164,39,24730,26.77,10,69.29,27
M6H2K1,2421,164,2,24732,25.45,1,75.00,2
M8Z3T7,2422,164,1,24733,28.16,0,63.26,1
M8Z2Y2,2423,164,5,24738,28.16,1,63.25,3
M4P2C3,2424,164,26,24764,26.25,7,71.52,19
M4P2N4,2425,164,8,24772,26.25,2,71.52,6
M8Z3T8,2426,164,7,24779,28.16,2,63.25,4
M8Z3E8,2427,164,5,24784,28.16,1,63.25,3
M4N2N5,2428,164,3,24787,23.78,1,82.22,2
M8Z3E1,2429,164,12,24799,28.16,3,63.24,8
M8Z2Y4,2430,164,12,24811,28.16,3,63.24,8
M8Z3E3,2431,164,7,24818,28.16,2,63.24,4
M8Z3E4,2432,164,18,24836,28.16,5,63.24,11
M8Z3V2,2433,164,14,24850,28.16,4,63.24,9
M8Y3P8,2434,164,28,24878,28.16,8,63.24,18
M8Y2M3,2435,164,8,24886,28.16,2,63.24,5
M8Z3C9,2436,164,18,24904,28.16,5,63.23,11
M8Y2V3,2437,164,8,24912,28.16,2,63.23,5
M8Z3V1,2438,164,13,24925,28.16,4,63.23,8
M6H3E3,2439,164,26,24951,25.45,7,74.97,19
M8Y2V4,2440,164,10,24961,28.16,3,63.23,6
M8Z3T9,2441,164,5,24966,28.16,1,63.22,3
M4S2K2,2442,164,7,24973,27.04,2,68.05,5
M4S1L8,2443,164,8,24981,27.04,2,68.05,5
M4S2L2,2444,164,10,24991,27.04,3,68.05,7
M8Z6E1,2445,164,7,24998,25.26,2,75.76,5
M4S1L7,2446,164,23,25021,27.04,6,68.05,16
M4S1R5,2447,164,9,25030,27.04,2,68.04,6
M4S2J4,2448,164,8,25038,27.04,2,68.04,5
M4S2J5,2449,164,4,25042,27.04,1,68.04,3
M8X2B5,2450,164,6,25048,26.01,2,72.50,4
M8Z3E2,2451,164,5,25053,28.15,1,63.23,3
M9B1X2,2452,164,1,25054,28.25,0,62.79,1
M4S2J1,2453,164,5,25059,27.04,1,68.03,3
M3H2C3,2454,164,4,25063,27.69,1,65.22,3
M4S2K3,2455,164,1,25064,27.04,0,68.03,1
L4J7N5,2456,164,15,25079,27.96,4,64.04,10
M3H3G7,2457,164,4,25083,27.69,1,65.21,3
M3H3G5,2458,164,6,25089,27.69,2,65.21,4
L4J7N4,2459,164,10,25099,27.96,3,64.04,6
M3H3C7,2460,164,5,25104,27.69,1,65.20,3
M3H3C4,2461,164,1,25105,27.69,0,65.20,1
M3H2B9,2462,164,12,25117,27.69,3,65.20,8
M3H2B3,2463,164,24,25141,27.69,7,65.20,16
M3H2C2,2464,164,23,25164,27.69,6,65.20,15
M3H2E4,2465,164,7,25171,27.69,2,65.20,5
M3H3G9,2466,164,6,25177,27.69,2,65.19,4
M3H2C4,2467,164,7,25184,27.69,2,65.19,5
M9B4H9,2468,164,9,25193,28.26,3,62.72,6
M3H3H1,2469,164,5,25198,27.69,1,65.19,3
M9B4G8,2470,164,11,25209,28.26,3,62.72,7
M3H3G8,2471,164,3,25212,27.69,1,65.19,2
M9B4E6,2472,164,11,25223,28.26,3,62.72,7
M9B4G7,2473,164,11,25234,28.26,3,62.71,7
L4J7N1,2474,164,10,25244,28.69,3,60.85,6
M9B1Z4,2475,164,5,25249,28.26,1,62.71,3
L4J7N3,2476,164,18,25267,28.69,5,60.85,11
M3H2C1,2477,164,3,25270,27.69,1,65.18,2
L4J7M7,2478,164,8,25278,28.69,2,60.85,5
L4J7N8,2479,164,19,25297,28.69,5,60.84,12
M9B1W6,2480,164,3,25300,28.26,1,62.71,2
M9B1X1,2481,164,2,25302,28.25,1,62.75,1
M9B1Z3,2482,164,4,25306,28.25,1,62.74,3
M9B1W7,2483,164,2,25308,28.26,1,62.70,1
M9B1W9,2484,164,3,25311,28.25,1,62.73,2
M9N2L2,2485,164,2,25313,26.74,1,69.27,1
M9A3W4,2486,164,9,25322,28.94,3,59.74,5
M9B4C4,2487,164,11,25333,28.25,3,62.73,7
M9N3E6,2488,164,1,25334,26.74,0,69.26,1
M9B4E5,2489,164,12,25346,28.25,3,62.72,8
M9A3W6,2490,164,16,25362,28.94,5,59.73,10
L3T6Y8,2491,164,8,25370,25.16,2,76.11,6
M9B4G6,2492,164,5,25375,28.25,1,62.72,3
M9B4G4,2493,164,13,25388,28.25,4,62.71,8
M9B4C5,2494,164,9,25397,28.25,3,62.71,6
M9B4H6,2495,164,19,25416,28.25,5,62.71,12
M9B3M2,2496,164,14,25430,28.25,4,62.71,9
M9B1T7,2497,164,1,25431,28.25,0,62.71,1
M9N2M7,2498,164,5,25436,26.74,1,69.25,3
M9N3H6,2499,164,8,25444,26.74,2,69.24,6
M9N3G4,2500,164,10,25454,26.74,3,69.24,7
M9N3H7,2501,164,5,25459,26.74,1,69.24,3
M9N2N6,2502,164,8,25467,26.74,2,69.24,6
M9N3G2,2503,164,11,25478,26.74,3,69.24,8
M9N3G1,2504,164,13,25491,26.74,3,69.24,9
M9N3G8,2505,164,13,25504,26.74,3,69.23,9
M9N2M5,2506,164,4,25508,26.74,1,69.23,3
M9N3E4,2507,164,13,25521,26.74,3,69.23,9
M9N3H2,2508,164,8,25529,26.74,2,69.23,6
M9N3G7,2509,164,16,25545,26.74,4,69.23,11
M9N2M4,2510,164,14,25559,26.74,4,69.23,10
M9N2N5,2511,164,6,25565,26.74,2,69.23,4
M9N2P4,2512,164,4,25569,26.74,1,69.23,3
M9N3H9,2513,164,3,25572,26.74,1,69.23,2
M9N2N8,2514,164,4,25576,26.74,1,69.22,3
M9N2M6,2515,164,1,25577,26.74,0,69.22,1
M9N3H1,2516,164,1,25578,26.74,0,69.21,1
M9N3G9,2517,164,5,25583,26.74,1,69.21,3
M9N3H3,2518,164,3,25586,26.74,1,69.20,2
M4W1X2,2519,164,13,25599,23.37,3,83.80,11
L3T5T2,2520,164,1,25600,25.83,0,73.06,1
M2N2X7,2521,164,6,25606,26.73,2,69.16,4
M2N2X5,2522,164,4,25610,26.73,1,69.16,3
M2N2X8,2523,164,2,25612,26.73,1,69.15,1
M2N2W5,2524,164,4,25616,26.73,1,69.15,3
M5N1M1,2525,164,57,25673,27.15,15,67.31,38
M6C3K5,2526,164,17,25690,27.00,5,67.95,12
M4G1N4,2527,164,11,25701,25.57,3,74.13,8
M4G1N3,2528,164,18,25719,25.57,5,74.13,13
M4G1P4,2529,164,17,25736,25.57,4,74.13,13
M4G2B4,2530,164,21,25757,25.57,5,74.13,16
M4G1T1,2531,164,2,25759,25.57,1,74.12,1
M4G1T3,2532,164,4,25763,25.57,1,74.11,3
L3T2A2,2533,164,12,25775,25.83,3,72.99,9
L3T2J9,2534,164,6,25781,25.83,2,72.99,4
L3T2J8,2535,164,6,25787,25.83,2,72.99,4
L3T2M2,2536,164,13,25800,25.83,3,72.98,9
L3T1Z8,2537,164,9,25809,25.83,2,72.98,7
L4J7T7,2538,164,28,25837,27.80,8,64.45,18
L3T2M9,2539,164,7,25844,25.83,2,72.98,5
L3T2A3,2540,164,13,25857,25.83,3,72.98,9
L3T2A4,2541,164,14,25871,25.83,4,72.98,10
L3T6X6,2542,164,16,25887,25.11,4,76.10,12
L3T2M7,2543,164,25,25912,25.83,6,72.98,18
L3T2M6,2544,164,10,25922,25.83,3,72.98,7
L3T6Y9,2545,164,15,25937,25.11,4,76.09,11
L3T2M1,2546,164,5,25942,25.83,1,72.97,4
L3T2M5,2547,164,22,25964,25.83,6,72.97,16
L3T7J9,2548,164,10,25974,25.73,3,73.40,7
L3T1Z9,2549,164,9,25983,25.83,2,72.97,7
L3T7A1,2550,164,9,25992,25.73,2,73.40,7
M4G1J8,2551,164,8,26000,25.56,2,74.13,6
L3T7J8,2552,164,9,26009,25.73,2,73.40,7
M4G1P6,2553,164,10,26019,25.56,3,74.13,7
L3T7A2,2554,164,12,26031,25.73,3,73.39,9
M4G1J9,2555,164,1,26032,25.56,0,74.13,1
L3T7E3,2556,164,9,26041,25.73,2,73.39,7
L3T2M8,2557,164,2,26043,25.83,1,72.96,1
L3T7C6,2558,164,9,26052,25.73,2,73.39,7
M4G2E8,2559,164,22,26074,25.56,6,74.13,16
L3T7E6,2560,164,9,26083,25.73,2,73.39,7
L3T4S4,2561,164,2,26085,25.83,1,72.93,1
L3T5H8,2562,164,1,26086,25.83,0,72.92,1
M4G4E7,2563,164,1,26087,27.71,0,64.75,1
L3T4W1,2564,164,1,26088,25.83,0,72.90,1
M4G2W9,2565,164,8,26096,27.71,2,64.74,5
M4G2X4,2566,164,3,26099,27.71,1,64.74,2
M4G2Z5,2567,164,7,26106,27.71,2,64.74,5
M4G1C3,2568,164,4,26110,27.71,1,64.73,3
M4G2X3,2569,164,5,26115,27.71,1,64.73,3
M5N2K6,2570,164,4,26119,27.87,1,64.04,3
M4G2X5,2571,164,3,26122,27.71,1,64.73,2
M4G1C1,2572,164,14,26136,27.71,4,64.73,9
M4G2X8,2573,164,3,26139,27.71,1,64.73,2
M4G1B3,2574,164,14,26153,27.71,4,64.73,9
M4G2Y5,2575,164,4,26157,27.71,1,64.73,3
M4G2X1,2576,164,16,26173,27.71,4,64.73,10
M4G1B5,2577,164,14,26187,27.71,4,64.72,9
M4G1C5,2578,164,2,26189,27.71,1,64.72,1
M4G2X2,2579,164,3,26192,27.71,1,64.72,2
M4G2X7,2580,164,3,26195,27.71,1,64.71,2
M5N2K2,2581,164,10,26205,27.87,3,64.01,6
M4G1A7,2582,164,1,26206,27.71,0,64.70,1
M4G1B6,2583,164,12,26218,27.70,3,64.73,8
M4G2Y4,2584,164,5,26223,27.70,1,64.73,3
M4G2X6,2585,164,3,26226,27.70,1,64.72,2
M4G1C4,2586,164,7,26233,27.70,2,64.72,5
M4G2Z2,2587,164,5,26238,27.70,1,64.72,3
M2N2Y5,2588,164,8,26246,26.72,2,68.97,6
M4G1B9,2589,164,7,26253,27.70,2,64.72,5
M2N2Y6,2590,164,14,26267,26.72,4,68.97,10
M9B4Z6,2591,164,3,26270,27.30,1,66.41,2
M9B4Z4,2592,164,14,26284,27.30,4,66.41,9
M9B4P7,2593,164,25,26309,28.05,7,63.15,16
M4G3Y1,2594,164,8,26317,26.14,2,71.42,6
M4G2T8,2595,164,6,26323,26.14,2,71.42,4
M4G2W7,2596,164,22,26345,26.14,6,71.42,16
M4G2W8,2597,164,32,26377,26.14,8,71.42,23
M4G3Y7,2598,163,7,26384,26.14,2,71.42,5
M4G3Y9,2599,163,12,26396,26.14,3,71.42,9
M6C1V6,2600,163,3,26399,28.11,1,62.88,2
M4G2W5,2601,163,4,26403,26.14,1,71.41,3
M4W2C6,2602,163,24,26427,23.30,6,83.70,20
M4W2B3,2603,163,18,26445,23.28,4,83.72,15
M9B5J4,2604,163,1,26446,28.16,0,62.57,1
M4N2A1,2605,163,28,26474,26.26,7,70.79,20
M4N2A9,2606,163,21,26495,26.26,6,70.79,15
M4N2B8,2607,163,11,26506,26.26,3,70.79,8
M4N2B7,2608,163,14,26520,26.26,4,70.79,10
M4N2C5,2609,163,9,26529,26.26,2,70.78,6
M4N2S5,2610,163,4,26533,26.26,1,70.78,3
M4N2V8,2611,163,2,26535,26.26,1,70.77,1
M2P2E8,2612,163,1,26536,24.42,0,78.72,1
M5M2H1,2613,163,3,26539,27.05,1,67.32,2
M4G1S6,2614,163,17,26556,27.94,5,63.45,11
M4G1Y5,2615,163,6,26562,27.94,2,63.45,4
M5M4K3,2616,163,2,26564,27.05,1,67.30,1
M9B3M4,2617,163,23,26587,28.48,7,61.11,14
M4G3N2,2618,163,14,26601,27.94,4,63.45,9
M4G1N9,2619,163,21,26622,27.94,6,63.45,13
M2P1H6,2620,163,5,26627,24.42,1,78.70,4
M4G1M5,2621,163,24,26651,27.94,7,63.45,15
M4G1N8,2622,163,19,26670,27.94,5,63.44,12
M5M4K5,2623,163,3,26673,27.05,1,67.30,2
M4G1S5,2624,163,11,26684,27.94,3,63.44,7
M5M2N2,2625,163,11,26695,27.05,3,67.29,7
M2P1R2,2626,163,5,26700,24.42,1,78.69,4
M2P1C1,2627,163,15,26715,24.42,4,78.69,12
M2P1E9,2628,163,20,26735,24.42,5,78.69,16
M2P1J4,2629,163,11,26746,24.42,3,78.69,9
M2P1E2,2630,163,21,26767,24.42,5,78.69,17
M2P1H5,2631,163,24,26791,24.42,6,78.69,19
M2P1E1,2632,163,19,26810,24.42,5,78.68,15
M2P1B9,2633,163,17,26827,24.42,4,78.68,13
M5M2L5,2634,163,18,26845,27.05,5,67.29,12
M2P1P8,2635,163,3,26848,24.42,1,78.68,2
M2P1K2,2636,163,6,26854,24.42,1,78.68,5
M2P1R1,2637,163,11,26865,24.42,3,78.68,9
M2L1K2,2638,163,13,26878,24.42,3,78.68,10
M2P1G2,2639,163,11,26889,24.42,3,78.68,9
M2P1V3,2640,163,11,26900,24.42,3,78.68,9
M5M4L4,2641,163,5,26905,27.05,1,67.28,3
M5M2H3,2642,163,5,26910,27.05,1,67.28,3
M5M2L6,2643,163,8,26918,27.05,2,67.28,5
M5M4L3,2644,163,5,26923,27.05,1,67.28,3
M5M2H2,2645,163,11,26934,27.05,3,67.28,7
M5M4K9,2646,163,5,26939,27.05,1,67.28,3
M5M2C4,2647,163,13,26952,27.05,4,67.28,9
M5M2C7,2648,163,6,26958,27.05,2,67.28,4
M2P1G1,2649,163,1,26959,24.42,0,78.67,1
M5M4L1,2650,163,5,26964,27.05,1,67.27,3
M5M4K6,2651,163,3,26967,27.05,1,67.26,2
L4J8L4,2652,163,23,26990,27.66,6,64.61,15
M5M4H1,2653,163,3,26993,27.12,1,66.90,2
M5M1B7,2654,163,27,27020,27.12,7,66.89,18
M8Z3L3,2655,163,5,27025,25.07,1,75.77,4
M8Z0A1,2656,163,28,27053,25.07,7,75.77,21
M8Z3A3,2657,163,35,27088,25.07,9,75.77,27
M8Z3L4,2658,163,27,27115,25.07,7,75.77,20
M6B2N1,2659,163,10,27125,26.37,3,70.12,7
M6B3E1,2660,163,6,27131,26.37,2,70.12,4
M6B3C9,2661,163,16,27147,26.37,4,70.11,11
M6B2T9,2662,163,17,27164,26.37,4,70.11,12
M6B2S1,2663,163,9,27173,26.37,2,70.11,6
M6B2T7,2664,163,14,27187,26.37,4,70.11,10
M6B2M9,2665,163,12,27199,26.37,3,70.11,8
M6B2K9,2666,163,15,27214,26.37,4,70.11,11
M6B2R9,2667,163,9,27223,26.37,2,70.11,6
M6B2S2,2668,163,7,27230,26.37,2,70.11,5
M6B2R8,2669,163,11,27241,26.37,3,70.11,8
M2K2G7,2670,163,14,27255,24.95,3,76.26,11
M2K2G6,2671,163,24,27279,24.95,6,76.25,18
M2K2G2,2672,163,7,27286,24.95,2,76.25,5
M2K2E8,2673,163,11,27297,24.95,3,76.24,8
M2K2H3,2674,163,14,27311,24.95,3,76.24,11
M2K2G3,2675,163,11,27322,24.95,3,76.24,8
M4W1X3,2676,163,1,27323,23.20,0,83.81,1
M4W2X8,2677,163,1,27324,23.20,0,83.81,1
M2K2H2,2678,163,4,27328,24.95,1,76.22,3
M5M1M7,2679,163,37,27365,25.93,10,71.97,27
M5M1P6,2680,163,38,27403,25.93,10,71.97,27
M4W2A3,2681,163,14,27417,23.20,3,83.80,12
M4W2B2,2682,163,33,27450,23.20,8,83.80,28
M4W1X1,2683,163,8,27458,23.20,2,83.80,7
M4W1X9,2684,163,4,27462,23.20,1,83.80,3
M4W2A2,2685,163,19,27481,23.20,4,83.79,16
M4W2A1,2686,163,6,27487,23.20,1,83.79,5
M5M2N9,2687,163,1,27488,27.70,0,64.29,1
M5N1T7,2688,163,6,27494,25.98,2,71.72,4
M3H2E6,2689,163,7,27501,27.48,2,65.20,5
M3H3G6,2690,163,7,27508,27.48,2,65.20,5
M3H2B8,2691,163,6,27514,27.48,2,65.20,4
M9A3V8,2692,163,2,27516,28.75,1,59.69,1
M3H3G3,2693,163,6,27522,27.48,2,65.19,4
M5M3W6,2694,163,5,27527,27.70,1,64.23,3
M4W2S8,2695,163,1,27528,23.20,0,83.72,1
M5M3R4,2696,163,8,27536,27.70,2,64.23,5
M5M3P5,2697,163,3,27539,27.70,1,64.23,2
M5M2N8,2698,163,14,27553,27.70,4,64.22,9
M5M2V1,2699,163,6,27559,27.70,2,64.22,4
M5M2T8,2700,163,9,27568,27.70,2,64.22,6
M5M3S6,2701,163,5,27573,27.70,1,64.22,3
M5M3R1,2702,163,9,27582,27.70,2,64.22,6
M5M2K3,2703,163,27,27609,27.70,7,64.22,17
M5M3W8,2704,163,10,27619,27.70,3,64.22,6
M5M2K5,2705,163,10,27629,27.70,3,64.22,6
M5M2P1,2706,163,2,27631,27.70,1,64.22,1
M5M3R3,2707,163,8,27639,27.70,2,64.22,5
M5M2M3,2708,163,11,27650,27.70,3,64.21,7
M5M3S5,2709,163,9,27659,27.70,2,64.21,6
M8Y2G9,2710,163,2,27661,28.73,1,59.75,1
M8Y1Y3,2711,163,5,27666,28.73,1,59.74,3
M8Y2E7,2712,163,8,27674,28.73,2,59.74,5
M8Y1Z8,2713,163,5,27679,28.73,1,59.74,3
M8Y4B2,2714,163,3,27682,28.73,1,59.74,2
M5M3W3,2715,163,3,27685,27.70,1,64.20,2
M8Y4B4,2716,163,2,27687,28.73,1,59.74,1
M8Y3K4,2717,163,14,27701,28.73,4,59.74,8
M8Y2A1,2718,163,9,27710,28.73,3,59.73,5
M8Y1Y8,2719,163,5,27715,28.73,1,59.73,3
M8Y1W8,2720,163,10,27725,28.73,3,59.73,6
M8Y2E8,2721,163,12,27737,28.73,3,59.73,7
M8Y2G7,2722,163,6,27743,28.73,2,59.73,4
M8Y4B9,2723,163,4,27747,28.73,1,59.73,2
M9B3G5,2724,163,2,27749,27.59,1,64.66,1
M8Y2H2,2725,163,5,27754,28.73,1,59.72,3
M8Y4E6,2726,163,3,27757,28.73,1,59.72,2
M9B6A1,2727,163,2,27759,27.59,1,64.66,1
M8Y1Z7,2728,163,4,27763,28.73,1,59.72,2
L4J1K2,2729,163,1,27764,26.11,0,71.07,1
M9B3H3,2730,163,14,27778,27.59,4,64.65,9
L4J1E9,2731,163,1,27779,26.11,0,71.06,1
L4J6X7,2732,163,1,27780,26.11,0,71.06,1
L4J1G6,2733,163,2,27782,26.11,1,71.02,1
L4J2B9,2734,163,3,27785,26.11,1,71.02,2
L4J2A3,2735,163,1,27786,26.11,0,71.01,1
L4J1G4,2736,163,3,27789,26.11,1,71.01,2
L4J2B6,2737,163,7,27796,26.11,2,71.01,5
L4J2B8,2738,163,9,27805,26.11,2,71.00,6
L4J2A2,2739,163,12,27817,26.11,3,71.00,9
L4J2B7,2740,163,7,27824,26.11,2,71.00,5
L4J6Z6,2741,163,11,27835,26.11,3,71.00,8
L4J8L1,2742,163,15,27850,26.11,4,71.00,11
L4J2A1,2743,163,34,27884,26.11,9,71.00,24
L4J1H3,2744,163,21,27905,26.11,5,71.00,15
L4J4R6,2745,163,20,27925,26.11,5,71.00,14
L4J1Y2,2746,163,9,27934,26.11,2,70.99,6
L4J2G1,2747,163,10,27944,26.11,3,70.99,7
L4J4R3,2748,163,18,27962,26.11,5,70.99,13
L4J1W3,2749,163,31,27993,26.11,8,70.99,22
L4J2E9,2750,163,11,28004,26.11,3,70.99,8
L4J8C5,2751,163,7,28011,26.11,2,70.99,5
L4J2A4,2752,163,4,28015,26.11,1,70.99,3
L4J1H7,2753,163,5,28020,26.11,1,70.99,4
L4J1G7,2754,163,3,28023,26.11,1,70.98,2
L4J1G8,2755,163,4,28027,26.11,1,70.98,3
L3T7H7,2756,163,16,28043,26.09,4,71.05,11
M5N2Y9,2757,163,1,28044,27.67,0,64.21,1
M5N2A5,2758,163,4,28048,27.67,1,64.19,3
M5N2B2,2759,163,6,28054,27.67,2,64.19,4
M5N2B7,2760,163,8,28062,27.67,2,64.19,5
M5N2Y8,2761,163,5,28067,27.67,1,64.19,3
M5N2A9,2762,163,3,28070,27.67,1,64.19,2
M5N2Y3,2763,163,8,28078,27.67,2,64.19,5
M5M1B5,2764,163,9,28087,27.67,2,64.19,6
M5N2W9,2765,163,8,28095,27.67,2,64.18,5
M5N2X3,2766,163,8,28103,27.67,2,64.18,5
M5M1B6,2767,163,6,28109,27.67,2,64.18,4
M5N2W8,2768,163,11,28120,27.67,3,64.18,7
M5N2Y6,2769,163,5,28125,27.67,1,64.18,3
M5N2Y7,2770,163,6,28131,27.67,2,64.18,4
M5N2Y2,2771,163,10,28141,27.67,3,64.18,6
M5N2B8,2772,163,7,28148,27.67,2,64.18,4
M5M1B8,2773,163,8,28156,27.67,2,64.18,5
M9B1T9,2774,163,3,28159,26.94,1,67.32,2
M5M1B9,2775,163,5,28164,27.67,1,64.16,3
M8X2E5,2776,163,4,28168,25.74,1,72.52,3
M5N2A3,2777,163,2,28170,27.67,1,64.15,1
M9B1X5,2778,163,2,28172,26.94,1,67.31,1
M9B1X4,2779,163,3,28175,26.94,1,67.30,2
M9B1V2,2780,163,5,28180,26.94,1,67.30,3
M9B4J5,2781,163,7,28187,26.94,2,67.29,5
M9B4K7,2782,163,9,28196,26.94,2,67.29,6
M9B1X3,2783,163,2,28198,26.94,1,67.29,1
M9B4J7,2784,163,9,28207,26.94,2,67.29,6
M9B4J8,2785,163,11,28218,26.94,3,67.29,7
M9B4J6,2786,163,6,28224,26.94,2,67.29,4
M9B1X6,2787,163,4,28228,26.94,1,67.29,3
M9B4K6,2788,163,6,28234,26.94,2,67.28,4
M9B1Z8,2789,163,3,28237,26.94,1,67.28,2
M5N2A8,2790,163,2,28239,27.65,1,64.18,1
M9A3G2,2791,163,10,28249,27.22,3,66.04,7
M3H1M2,2792,163,10,28259,27.49,3,64.86,6
M4S3H9,2793,163,1,28260,26.19,0,70.49,1
M5N1P3,2794,163,34,28294,23.96,8,80.08,27
M8Z4Y9,2795,163,4,28298,24.95,1,75.78,3
M9R2W1,2796,163,15,28313,28.12,4,62.04,9
M8Z3C4,2797,163,16,28329,24.95,4,75.77,12
M8Z3J2,2798,163,42,28371,24.95,10,75.77,32
M8Z3J1,2799,163,12,28383,24.95,3,75.76,9
M8Z4S5,2800,163,4,28387,24.95,1,75.76,3
M8Z4X1,2801,163,6,28393,24.95,1,75.76,5
M8Z3H9,2802,163,6,28399,24.95,1,75.76,5
M4S2P7,2803,163,16,28415,25.74,4,72.32,12
M8Z4Z1,2804,163,4,28419,24.95,1,75.75,3
M9R2V6,2805,163,17,28436,28.11,5,62.05,11
M9R2W5,2806,163,11,28447,28.11,3,62.05,7
M9R2V9,2807,163,11,28458,28.11,3,62.05,7
M8X1N2,2808,163,1,28459,25.67,0,72.61,1
M9R2V7,2809,163,11,28470,28.11,3,62.04,7
M9R2W3,2810,163,2,28472,28.11,1,62.03,1
M9R2V5,2811,163,7,28479,28.11,2,62.03,4
M9B2B5,2812,163,2,28481,28.02,1,62.42,1
M4N2B1,2813,163,29,28510,24.14,7,79.19,23
M8X2G2,2814,163,8,28518,25.67,2,72.56,6
M8X2G6,2815,163,17,28535,25.67,4,72.56,12
M8X2G8,2816,163,19,28554,25.67,5,72.55,14
M8X2H7,2817,163,16,28570,25.67,4,72.55,12
M8X2J8,2818,163,7,28577,25.67,2,72.55,5
M8X2H8,2819,163,14,28591,25.67,4,72.55,10
M8X2J7,2820,163,14,28605,25.67,4,72.55,10
M8X2K4,2821,163,12,28617,25.67,3,72.55,9
M8X2G5,2822,163,13,28630,25.67,3,72.55,9
M5M1K1,2823,163,35,28665,26.50,9,68.95,24
M5M1L8,2824,163,30,28695,26.50,8,68.95,21
M8X1M2,2825,163,3,28698,25.67,1,72.55,2
M5M1E7,2826,163,19,28717,26.50,5,68.95,13
M5M1K2,2827,163,22,28739,26.50,6,68.95,15
M8X1L7,2828,163,5,28744,25.67,1,72.55,4
M8X2H6,2829,163,7,28751,25.67,2,72.54,5
M8X2H5,2830,163,9,28760,25.67,2,72.54,7
M8X2J6,2831,163,7,28767,25.67,2,72.54,5
M4N3G9,2832,163,1,28768,24.14,0,79.16,1
M8X1L9,2833,163,4,28772,25.67,1,72.53,3
M8X2Y7,2834,163,1,28773,25.67,0,72.53,1
M4G2E7,2835,163,25,28798,25.30,6,74.13,19
M4G2H2,2836,163,22,28820,25.30,6,74.13,16
M4G1P7,2837,163,5,28825,25.30,1,74.12,4
M4G2B3,2838,163,2,28827,25.30,1,74.12,1
M5M1N1,2839,163,20,28847,26.11,5,70.61,14
M4N3H2,2840,163,1,28848,24.14,0,79.14,1
M5M1P9,2841,163,20,28868,26.11,5,70.60,14
M4N3M8,2842,163,2,28870,24.14,0,79.13,2
M4N3B4,2843,163,2,28872,24.14,0,79.13,2
M4N3B2,2844,163,7,28879,24.14,2,79.13,6
M4N1T6,2845,163,12,28891,24.14,3,79.12,9
M4N3B9,2846,163,3,28894,24.14,1,79.12,2
M4N1R1,2847,163,16,28910,24.14,4,79.12,13
M4N1R5,2848,163,20,28930,24.14,5,79.12,16
M4N1R6,2849,163,18,28948,24.14,4,79.12,14
M4N1P1,2850,163,17,28965,24.14,4,79.12,13
M4N3B8,2851,163,4,28969,24.14,1,79.12,3
M4N1P9,2852,163,20,28989,24.14,5,79.12,16
M4N1T5,2853,163,1,28990,24.14,0,79.12,1
M4N3G8,2854,163,1,28991,24.14,0,79.09,1
M4N1P8,2855,163,1,28992,24.14,0,79.07,1
M9A4C6,2856,163,2,28994,26.28,1,69.78,1
M9B4H7,2857,163,10,29004,26.99,3,66.70,7
L4J7L6,2858,163,10,29014,26.40,3,69.25,7
L4J7L5,2859,163,18,29032,26.40,5,69.24,12
M8X1W9,2860,163,10,29042,27.32,3,65.24,7
L3T7E2,2861,163,14,29056,25.99,4,70.98,10
L3T7A3,2862,163,9,29065,25.84,2,71.62,6
M5M1L2,2863,163,21,29086,26.15,5,70.27,15
M5M1M9,2864,163,20,29106,26.15,5,70.26,14
M9A4P9,2865,163,14,29120,26.26,4,69.78,10
M9B3N7,2866,163,1,29121,28.25,0,61.16,1
M9B3S9,2867,162,3,29124,26.56,1,68.41,2
M9B3S8,2868,162,6,29130,26.57,2,68.36,4
M9B3T2,2869,162,6,29136,26.56,2,68.39,4
M9B1G3,2870,162,2,29138,26.56,1,68.39,1
M9B1G5,2871,162,16,29154,26.56,4,68.38,11
M9B1G4,2872,162,16,29170,26.56,4,68.38,11
M9B1L8,2873,162,14,29184,26.56,4,68.38,10
M9B3V3,2874,162,6,29190,26.56,2,68.38,4
M9B3T1,2875,162,6,29196,26.56,2,68.37,4
M8Y3S6,2876,162,1,29197,28.48,0,60.05,1
M9B1G1,2877,162,15,29212,26.56,4,68.37,10
M9B3R9,2878,162,8,29220,26.56,2,68.37,5
M9B1G7,2879,162,2,29222,26.56,1,68.37,1
M9B3R7,2880,162,6,29228,26.56,2,68.37,4
M9B1G9,2881,162,10,29238,26.56,3,68.37,7
M9B3S7,2882,162,2,29240,26.56,1,68.37,1
M9B1H1,2883,162,10,29250,26.56,3,68.37,7
M4W2V9,2884,162,4,29254,23.40,1,82.05,3
M8Y4B5,2885,162,2,29256,28.48,1,60.01,1
M8Y3V7,2886,162,8,29264,28.48,2,60.00,5
M8Y2E4,2887,162,1,29265,28.48,0,60.00,1
M8Y2E3,2888,162,12,29277,28.48,3,60.00,7
M8Y3W2,2889,162,6,29283,28.48,2,60.00,4
M8Y2C8,2890,162,11,29294,28.48,3,60.00,7
M8Y3R9,2891,162,9,29303,28.48,3,60.00,5
M8Y2C3,2892,162,4,29307,28.48,1,60.00,2
M8Y3W5,2893,162,4,29311,28.48,1,60.00,2
M8Y1Z2,2894,162,17,29328,28.48,5,59.99,10
M8Y2C5,2895,162,9,29337,28.48,3,59.99,5
M8Y3W1,2896,162,7,29344,28.48,2,59.99,4
M8Y3V8,2897,162,5,29349,28.48,1,59.99,3
M8Y3S7,2898,162,2,29351,28.48,1,59.99,1
M8Y1Z5,2899,162,16,29367,28.48,5,59.99,10
M8Y2C4,2900,162,6,29373,28.48,2,59.99,4
M8Y1Y6,2901,162,17,29390,28.48,5,59.99,10
M8Y1Z3,2902,162,18,29408,28.48,5,59.99,11
M8Y2C7,2903,162,12,29420,28.48,3,59.99,7
M8Y2E2,2904,162,9,29429,28.48,3,59.98,5
M8Y2G1,2905,162,10,29439,28.48,3,59.98,6
M6J3V1,2906,162,5,29444,27.13,1,65.83,3
M8Y4B7,2907,162,6,29450,28.48,2,59.98,4
M8Y2C2,2908,162,6,29456,28.48,2,59.97,4
L4J6Z7,2909,162,16,29472,25.82,4,71.47,11
M4G3M8,2910,162,12,29484,27.67,3,63.44,8
M9A3M2,2911,162,9,29493,26.90,2,66.76,6
M2L1G8,2912,162,2,29495,25.60,1,72.38,1
M4R1Z7,2913,162,9,29504,26.10,2,70.21,6
M2L1J6,2914,162,1,29505,25.60,0,72.37,1
M4R1E9,2915,162,40,29545,26.10,10,70.21,28
M9B1P7,2916,162,3,29548,27.56,1,63.88,2
L4J7M4,2917,162,18,29566,27.55,5,63.92,12
M2L1L7,2918,162,4,29570,25.60,1,72.36,3
M6J3X3,2919,162,52,29622,27.11,14,65.81,34
M2L1L9,2920,162,7,29629,25.60,2,72.35,5
M2L1L8,2921,162,4,29633,25.60,1,72.35,3
M2L1G9,2922,162,5,29638,25.60,1,72.35,4
M2L1J2,2923,162,3,29641,25.60,1,72.35,2
M2L1J1,2924,162,10,29651,25.60,3,72.35,7
M2L1L6,2925,162,2,29653,25.60,1,72.35,1
M9B1S6,2926,162,2,29655,27.56,1,63.86,1
M2L1J3,2927,162,9,29664,25.60,2,72.35,7
M2L1K3,2928,162,11,29675,25.60,3,72.35,8
M2L1G7,2929,162,13,29688,25.60,3,72.35,9
M2L1M3,2930,162,8,29696,25.60,2,72.35,6
M2L1K6,2931,162,12,29708,25.60,3,72.35,9
M2L1J5,2932,162,13,29721,25.60,3,72.35,9
M2L1K4,2933,162,9,29730,25.60,2,72.34,7
M2L1M1,2934,162,6,29736,25.60,2,72.34,4
M2L1G6,2935,162,8,29744,25.60,2,72.33,6
M8Y2C6,2936,162,1,29745,28.47,0,59.90,1
M2L1J4,2937,162,5,29750,25.60,1,72.33,4
M9B4V5,2938,162,12,29762,27.56,3,63.83,8
M9B4V2,2939,162,7,29769,27.56,2,63.83,4
M9B1W3,2940,162,3,29772,27.56,1,63.83,2
M9B4T6,2941,162,9,29781,27.56,2,63.83,6
M9B1W2,2942,162,3,29784,27.56,1,63.83,2
M9B4V8,2943,162,8,29792,27.56,2,63.83,5
M9B4V1,2944,162,15,29807,27.56,4,63.83,10
M9B4W4,2945,162,10,29817,27.56,3,63.83,6
M9B1Y4,2946,162,6,29823,27.56,2,63.83,4
M9B4V7,2947,162,12,29835,27.56,3,63.82,8
M2L2Y3,2948,162,2,29837,25.60,1,72.32,1
M9N3P4,2949,162,3,29840,26.32,1,69.20,2
M9B4W2,2950,162,4,29844,27.56,1,63.82,3
M9B1P3,2951,162,12,29856,27.56,3,63.82,8
M9B1Y6,2952,162,3,29859,27.56,1,63.82,2
M9B2A8,2953,162,6,29865,27.56,2,63.81,4
M9B1P8,2954,162,2,29867,27.56,1,63.81,1
M6C1Y4,2955,162,5,29872,27.77,1,62.87,3
M6C3A8,2956,162,11,29883,27.77,3,62.87,7
M6C3A7,2957,162,14,29897,27.77,4,62.87,9
M6C1V7,2958,162,7,29904,27.77,2,62.87,4
M2L2X6,2959,162,2,29906,25.60,1,72.27,1
M6C3B9,2960,162,9,29915,27.77,2,62.86,6
M6C1V9,2961,162,7,29922,27.77,2,62.86,4
L3T5H9,2962,162,2,29924,26.41,1,68.75,1
M6C1V8,2963,162,4,29928,27.77,1,62.85,3
L4J8L3,2964,162,23,29951,27.52,6,63.93,15
M6C3C1,2965,162,6,29957,27.76,2,62.87,4
M6C1V4,2966,162,3,29960,27.76,1,62.86,2
M6B4G2,2967,162,2,29962,26.32,1,69.08,1
L4J1H8,2968,162,12,29974,26.18,3,69.68,8
M6S3J1,2969,162,14,29988,26.10,4,70.03,10
L4J7M8,2970,162,11,29999,27.50,3,63.95,7
M6P2T8,2971,162,35,30034,25.41,9,73.00,26
M6S5B4,2972,162,25,30059,25.79,6,71.31,18
M6S5B6,2973,162,39,30098,25.79,10,71.31,28
M6S5B7,2974,162,29,30127,25.79,7,71.31,21
L4J8K6,2975,162,38,30165,27.59,10,63.50,24
M6C4A3,2976,162,1,30166,27.74,0,62.85,1
M8X2P4,2977,162,3,30169,27.56,1,63.63,2
M5N1T5,2978,162,16,30185,25.99,4,70.41,11
M5N1T3,2979,162,1,30186,25.99,0,70.40,1
M5M3T8,2980,162,3,30189,26.68,1,67.40,2
M5M2H9,2981,162,2,30191,27.57,1,63.53,1
L4J6Z5,2982,162,9,30200,25.93,2,70.60,6
L4J7B8,2983,162,17,30217,25.86,4,70.90,12
L4J7C2,2984,162,17,30234,25.86,4,70.90,12
L4J7B9,2985,162,18,30252,25.86,5,70.90,13
L4J7C1,2986,162,10,30262,25.86,3,70.89,7
L4J8N3,2987,162,33,30295,27.56,9,63.50,21
M5M1Y9,2988,162,38,30333,26.70,10,67.23,26
M5N2L2,2989,162,23,30356,28.14,6,60.99,14
M9R2N4,2990,162,2,30358,27.99,1,61.62,1
M9R1C5,2991,162,5,30363,27.99,1,61.61,3
M9R2S1,2992,162,2,30365,27.99,1,61.60,1
M6P2T6,2993,162,2,30367,26.82,1,66.67,1
M9R2V1,2994,162,18,30385,27.99,5,61.59,11
M9R1A4,2995,162,15,30400,27.99,4,61.58,9
M9R4A4,2996,162,22,30422,27.99,6,61.58,14
M9R1C4,2997,162,6,30428,27.99,2,61.58,4
M9R2R8,2998,162,33,30461,27.99,9,61.58,20
M9R2X4,2999,162,3,30464,27.99,1,61.58,2
M9R2V2,3000,162,15,30479,27.99,4,61.58,9
M9R1C6,3001,162,6,30485,27.99,2,61.58,4
M9R2S3,3002,162,20,30505,27.99,6,61.58,12
L3T7E4,3003,162,10,30515,26.06,3,69.93,7
M9R1C3,3004,162,1,30516,27.99,0,61.56,1
M6J2H1,3005,162,9,30525,24.45,2,76.87,7
M9B4K9,3006,162,10,30535,27.85,3,62.14,6
M6J3W9,3007,162,39,30574,27.00,11,65.82,26
M6J3T9,3008,162,32,30606,27.00,9,65.82,21
M6J3T5,3009,162,11,30617,27.00,3,65.82,7
M6J3T1,3010,162,24,30641,27.00,6,65.82,16
M6P2V8,3011,162,29,30670,26.82,8,66.59,19
L4J7N9,3012,162,18,30688,27.41,5,64.03,12
M3A2L1,3013,162,5,30693,25.76,1,71.17,4
L3T7A4,3014,162,10,30703,25.59,3,71.90,7
M5M1H3,3015,162,22,30725,26.58,6,67.61,15
M5M1E8,3016,162,30,30755,26.58,8,67.60,20
M2N1C2,3017,162,3,30758,27.22,1,64.82,2
M2N1E6,3018,162,17,30775,27.22,5,64.81,11
M2N1G5,3019,162,21,30796,27.22,6,64.81,14
M2N1E5,3020,162,19,30815,27.22,5,64.81,12
M2N1C7,3021,162,12,30827,27.22,3,64.81,8
M2N2K5,3022,162,3,30830,27.22,1,64.80,2
M2N1C5,3023,162,2,30832,27.22,1,64.80,1
M3A1N2,3024,162,3,30835,25.74,1,71.20,2
M5M1K9,3025,162,38,30873,25.56,10,71.97,27
M3A2K9,3026,162,4,30877,25.74,1,71.19,3
M3A1M7,3027,162,15,30892,25.74,4,71.18,11
M3A1M8,3028,162,6,30898,25.74,2,71.18,4
M3A1M9,3029,162,19,30917,25.74,5,71.18,14
M3A1H5,3030,162,48,30965,25.74,12,71.18,34
M6J3C2,3031,162,22,30987,24.13,5,78.15,17
M3A1M6,3032,162,18,31005,25.74,5,71.17,13
M3A1N1,3033,162,6,31011,25.74,2,71.17,4
M2R1B5,3034,162,5,31016,26.39,1,68.33,3
M2R1A5,3035,162,10,31026,26.39,3,68.33,7
M2R1V1,3036,162,7,31033,26.39,2,68.33,5
M6J1H3,3037,162,5,31038,24.12,1,78.16,4
M2R1C1,3038,162,15,31053,26.39,4,68.33,10
M2R3X5,3039,162,9,31062,26.39,2,68.32,6
M2R1B1,3040,162,11,31073,26.39,3,68.32,8
M2R1C3,3041,162,12,31085,26.39,3,68.32,8
M2R1B3,3042,162,21,31106,26.39,6,68.32,14
M2R1A4,3043,162,23,31129,26.39,6,68.32,16
M2R1E6,3044,162,13,31142,26.39,3,68.32,9
M2R1C2,3045,162,16,31158,26.39,4,68.32,11
M2R1T5,3046,162,7,31165,26.39,2,68.32,5
M2R1S6,3047,162,3,31168,26.39,1,68.32,2
M2R1H1,3048,162,11,31179,26.39,3,68.32,8
M2R1E7,3049,162,15,31194,26.39,4,68.32,10
M2R1S7,3050,162,6,31200,26.39,2,68.32,4
M2R1B4,3051,162,8,31208,26.39,2,68.32,5
M8Z2Z3,3052,162,9,31217,24.67,2,75.77,7
M2R1T8,3053,162,4,31221,26.39,1,68.31,3
M2R1S9,3054,162,4,31225,26.39,1,68.31,3
M8Z3A4,3055,162,13,31238,24.67,3,75.76,10
M2R1T7,3056,162,5,31243,26.39,1,68.31,3
M2R1V3,3057,162,3,31246,26.39,1,68.31,2
M4S2S2,3058,162,3,31249,25.86,1,70.59,2
M4S1M2,3059,162,10,31259,25.86,3,70.59,7
M4S1R8,3060,162,21,31280,25.86,5,70.59,15
M4S2P3,3061,162,18,31298,25.86,5,70.59,13
M4S1S1,3062,162,9,31307,25.86,2,70.58,6
M4S1S3,3063,162,16,31323,25.86,4,70.58,11
M4S1P3,3064,162,20,31343,25.86,5,70.58,14
M4S1M4,3065,162,20,31363,25.86,5,70.58,14
M4S1R9,3066,162,5,31368,25.86,1,70.58,4
M4S1M1,3067,162,5,31373,25.86,1,70.58,4
M4S1P4,3068,162,17,31390,25.86,4,70.58,12
M4S2N8,3069,162,15,31405,25.86,4,70.58,11
M4S2N9,3070,162,14,31419,25.86,4,70.58,10
M4S2R8,3071,162,7,31426,25.86,2,70.57,5
M3B3E4,3072,162,1,31427,24.36,0,77.04,1
L4J4V5,3073,162,10,31437,27.99,3,61.31,6
L4J4S9,3074,162,9,31446,27.99,3,61.31,6
L4J4T9,3075,162,10,31456,27.99,3,61.30,6
L4J4T6,3076,162,10,31466,27.99,3,61.30,6
M3B2C4,3077,162,11,31477,24.36,3,77.02,8
M3B3J3,3078,162,2,31479,24.36,0,77.02,2
M3B1S6,3079,162,9,31488,24.36,2,77.02,7
M3B2L8,3080,162,9,31497,24.36,2,77.02,7
M3B1T5,3081,162,8,31505,24.36,2,77.02,6
M3B3E1,3082,162,14,31519,24.36,3,77.02,11
M3B2L7,3083,162,10,31529,24.36,2,77.02,8
M3B2B8,3084,162,2,31531,24.36,0,77.01,2
M3B3J7,3085,162,3,31534,24.36,1,77.01,2
M3B1R6,3086,162,16,31550,24.36,4,77.01,12
M3B3J9,3087,162,2,31552,24.36,0,77.01,2
M3B1S5,3088,162,17,31569,24.36,4,77.01,13
M3B2C2,3089,162,7,31576,24.36,2,77.01,5
M3B3J2,3090,162,5,31581,24.36,1,77.01,4
M3B3B1,3091,162,11,31592,24.36,3,77.01,8
M2L2R2,3092,162,11,31603,25.71,3,71.15,8
M2L2V1,3093,162,5,31608,25.71,1,71.15,4
M2L2P4,3094,162,6,31614,25.71,2,71.14,4
M2L2P8,3095,162,12,31626,25.71,3,71.14,9
M2L2R5,3096,162,28,31654,25.71,7,71.14,20
M2L2T8,3097,162,11,31665,25.71,3,71.14,8
M2L2R6,3098,162,28,31693,25.71,7,71.14,20
M2L2R1,3099,162,4,31697,25.71,1,71.14,3
M2L2P9,3100,162,20,31717,25.71,5,71.14,14
M2L2P5,3101,162,18,31735,25.71,5,71.14,13
M2L2R4,3102,162,16,31751,25.71,4,71.14,11
M8Y2V1,3103,162,3,31754,27.53,1,63.25,2
M8Y2M6,3104,162,6,31760,27.53,2,63.25,4
M3B2C3,3105,162,9,31769,24.35,2,77.02,7
L4L2B2,3106,162,2,31771,26.44,1,67.96,1
M6S1K5,3107,162,2,31773,27.13,1,64.97,1
M6S1H1,3108,162,8,31781,27.13,2,64.97,5
M8Y3P7,3109,162,13,31794,27.53,4,63.24,8
M8Z2Y3,3110,162,8,31802,27.53,2,63.24,5
M6S1G2,3111,162,9,31811,27.13,2,64.97,6
M6S3K8,3112,162,8,31819,27.13,2,64.97,5
M6S1J8,3113,162,8,31827,27.13,2,64.96,5
M6S1K7,3114,162,18,31845,27.13,5,64.96,12
M6S1G1,3115,162,15,31860,27.13,4,64.96,10
M6S1K1,3116,162,15,31875,27.13,4,64.96,10
M6S1L5,3117,162,11,31886,27.13,3,64.96,7
M6S1H2,3118,162,10,31896,27.13,3,64.96,6
M3B3G6,3119,162,3,31899,24.35,1,77.00,2
M6S1K4,3120,162,12,31911,27.13,3,64.96,8
M6S1J9,3121,162,16,31927,27.13,4,64.96,10
M6S3X2,3122,162,6,31933,27.13,2,64.96,4
M6S3P7,3123,162,6,31939,27.13,2,64.96,4
L4J7M2,3124,162,10,31949,27.34,3,64.04,6
M6S3X1,3125,162,4,31953,27.13,1,64.95,3
L4J7M3,3126,162,18,31971,27.34,5,64.03,12
L3T6W6,3127,162,17,31988,25.58,4,71.65,12
L3T6Y2,3128,162,10,31998,25.58,3,71.65,7
L3T6Y3,3129,162,13,32011,25.58,3,71.65,9
L3T6Y1,3130,162,9,32020,25.58,2,71.65,6
L3T6X9,3131,162,17,32037,25.58,4,71.65,12
L3T6X8,3132,162,10,32047,25.58,3,71.65,7
L3T6X7,3133,162,9,32056,25.58,2,71.65,6
L3T6X4,3134,162,9,32065,25.58,2,71.64,6
L3T6W9,3135,162,16,32081,25.58,4,71.64,11
M9B4H8,3136,162,10,32091,26.72,3,66.70,7
L4J8G9,3137,162,44,32135,27.13,12,64.91,29
M4V2S4,3138,162,10,32145,26.28,3,68.59,7
M4V1W2,3139,162,6,32151,26.28,2,68.59,4
M5P2V7,3140,162,6,32157,26.28,2,68.59,4
M4V2P7,3141,162,11,32168,26.28,3,68.58,8
M9P2K1,3142,162,1,32169,26.82,0,66.23,1
M9B1Z5,3143,162,9,32178,27.63,2,62.72,6
M4V2X2,3144,162,4,32182,26.28,1,68.57,3
L4J8L6,3145,162,38,32220,28.06,11,60.85,23
L4J8K8,3146,162,46,32266,28.06,13,60.85,28
L4J7N2,3147,162,11,32277,28.06,3,60.85,7
L4J7N6,3148,162,18,32295,28.06,5,60.84,11
L4J7N7,3149,162,10,32305,28.06,3,60.84,6
M5M1H4,3150,161,30,32335,26.60,8,67.17,20
L4J8W2,3151,161,3,32338,28.06,1,60.84,2
M4V1W9,3152,161,1,32339,26.28,0,68.54,1
M9B1W1,3153,161,2,32341,27.37,1,63.80,1
M9P2E1,3154,161,1,32342,26.82,0,66.17,1
M9P3J8,3155,161,1,32343,26.82,0,66.17,1
L4J9J9,3156,161,1,32344,28.06,0,60.79,1
M9B1Y5,3157,161,1,32345,27.35,0,63.86,1
M9B1S5,3158,161,1,32346,27.35,0,63.86,1
L4L6Y3,3159,161,10,32356,26.24,3,68.66,7
L4L6Y4,3160,161,18,32374,26.24,5,68.66,12
M9P2G6,3161,161,10,32384,26.82,3,66.15,7
L4L6Y9,3162,161,18,32402,26.24,5,68.66,12
M9P2G5,3163,161,9,32411,26.82,2,66.14,6
M9P2K2,3164,161,12,32423,26.82,3,66.14,8
M9P2E9,3165,161,13,32436,26.82,3,66.14,9
M9P3K7,3166,161,1,32437,26.82,0,66.14,1
M9P2G7,3167,161,8,32445,26.82,2,66.14,5
M9B1P5,3168,161,2,32447,27.35,1,63.84,1
M9P2J9,3169,161,26,32473,26.82,7,66.13,17
M9P3K6,3170,161,1,32474,26.82,0,66.13,1
M9P3J9,3171,161,1,32475,26.82,0,66.13,1
M9P2G2,3172,161,23,32498,26.82,6,66.13,15
M9B4T9,3173,161,11,32509,27.35,3,63.84,7
M4V2X3,3174,161,1,32510,26.28,0,68.47,1
M9P2G4,3175,161,16,32526,26.82,4,66.13,11
M9P2J8,3176,161,1,32527,26.82,0,66.13,1
M9P2J6,3177,161,2,32529,26.82,1,66.13,1
M9P2G8,3178,161,8,32537,26.82,2,66.13,5
M9B4V3,3179,161,7,32544,27.35,2,63.83,4
M9B4T2,3180,161,27,32571,27.35,7,63.83,17
M9B4T8,3181,161,13,32584,27.35,4,63.83,8
M9P2J7,3182,161,7,32591,26.82,2,66.12,5
M9B4V4,3183,161,11,32602,27.35,3,63.83,7
M9P2E7,3184,161,4,32606,26.82,1,66.12,3
M9B1S4,3185,161,2,32608,27.35,1,63.82,1
M9B4T7,3186,161,11,32619,27.35,3,63.82,7
M4G2H1,3187,161,25,32644,25.36,6,72.44,18
M9B4T4,3188,161,5,32649,27.35,1,63.81,3
M9B1P6,3189,161,2,32651,27.35,1,63.81,1
M9B1V9,3190,161,1,32652,27.35,0,63.81,1
L4J6P6,3191,161,10,32662,28.00,3,60.99,6
L4J6P3,3192,161,10,32672,28.00,3,60.99,6
L4J6P1,3193,161,11,32683,28.00,3,60.98,7
L4J6N8,3194,161,16,32699,28.00,4,60.98,10
L4J6P4,3195,161,15,32714,28.00,4,60.98,9
L4J6P2,3196,161,12,32726,28.00,3,60.98,7
L4J6N6,3197,161,10,32736,28.00,3,60.98,6
L4J6P7,3198,161,15,32751,28.00,4,60.98,9
L4J2Y9,3199,161,23,32774,28.00,6,60.98,14
L4J6P5,3200,161,18,32792,28.00,5,60.98,11
L4J3H6,3201,161,17,32809,28.00,5,60.97,10
L4J4E7,3202,161,30,32839,28.00,8,60.97,18
L4J6N7,3203,161,18,32857,28.00,5,60.97,11
L4J6N9,3204,161,10,32867,28.00,3,60.97,6
M5M4E5,3205,161,1,32868,27.07,0,64.98,1
M4B1R3,3206,161,4,32872,28.40,1,59.21,2
M4B1R5,3207,161,5,32877,28.40,1,59.21,3
M2N2W2,3208,161,15,32892,26.89,4,65.74,10
M5M1T5,3209,161,13,32905,27.07,4,64.94,8
M5M1R1,3210,161,12,32917,27.07,3,64.94,8
M5M1R2,3211,161,12,32929,27.07,3,64.94,8
M5M1T6,3212,161,12,32941,27.07,3,64.94,8
M8Z0B1,3213,161,30,32971,24.57,7,75.77,23
M8Z0B2,3214,161,20,32991,24.57,5,75.77,15
L3T5J9,3215,161,10,33001,26.74,3,66.36,7
L3T5K6,3216,161,9,33010,26.74,2,66.36,6
M4N2Y5,3217,161,10,33020,24.44,2,76.32,8
L3T5R8,3218,161,6,33026,26.74,2,66.35,4
M3A2M2,3219,161,16,33042,27.54,4,62.86,10
M3A2L9,3220,161,12,33054,27.54,3,62.86,8
M3A2M1,3221,161,27,33081,27.54,7,62.86,17
M3A2M6,3222,161,23,33104,27.54,6,62.86,14
M3A2M7,3223,161,3,33107,27.54,1,62.85,2
M2N2W3,3224,161,16,33123,26.87,4,65.72,11
M4G4K5,3225,161,1,33124,25.55,0,71.43,1
M4G2S7,3226,161,12,33136,25.55,3,71.42,9
M2N1E4,3227,161,9,33145,27.24,2,64.10,6
M4G2T1,3228,161,14,33159,25.55,4,71.41,10
M4W3T9,3229,161,94,33253,26.09,25,69.07,65
M9A3G3,3230,161,7,33260,28.21,2,59.86,4
M5N2K1,3231,161,12,33272,27.25,3,64.01,8
M5N1G5,3232,161,3,33275,27.25,1,64.01,2
M4N2E9,3233,161,20,33295,21.76,4,87.78,18
M9B4Z9,3234,161,11,33306,26.69,3,66.42,7
M6B1T9,3235,161,7,33313,26.98,2,65.15,5
M6B1T5,3236,161,29,33342,26.98,8,65.14,19
L4J5B4,3237,161,18,33360,26.63,5,66.66,12
M9B3H4,3238,161,1,33361,26.73,0,66.22,1
M9A2M1,3239,161,10,33371,26.58,3,66.85,7
M6S1M3,3240,161,7,33378,25.84,2,70.04,5
M6S4A7,3241,161,5,33383,25.84,1,70.04,4
M6S1B6,3242,161,14,33397,25.84,4,70.03,10
M6S4W7,3243,161,14,33411,25.84,4,70.03,10
M6S1B5,3244,161,21,33432,25.84,5,70.03,15
M6S4J2,3245,161,29,33461,25.84,7,70.03,20
M6S4J1,3246,161,7,33468,25.84,2,70.02,5
M6S1G6,3247,161,8,33476,25.84,2,70.02,6
M6C3E4,3248,161,2,33478,27.49,1,62.86,1
M5M2B7,3249,161,17,33495,28.12,5,60.12,10
M5M1Z4,3250,161,14,33509,28.12,4,60.12,8
M9B3A7,3251,161,2,33511,26.73,1,66.14,1
M5M1Z5,3252,161,18,33529,28.12,5,60.12,11
M9B3C7,3253,161,6,33535,26.73,2,66.13,4
M9B3C8,3254,161,11,33546,26.73,3,66.13,7
M9B5T5,3255,161,17,33563,26.73,5,66.12,11
M9B4M5,3256,161,13,33576,26.73,3,66.12,9
M9B5V6,3257,161,3,33579,26.73,1,66.12,2
M9B3E1,3258,161,18,33597,26.73,5,66.12,12
M9B4M4,3259,161,14,33611,26.73,4,66.12,9
M9B6A5,3260,161,32,33643,26.73,9,66.12,21
M9B3E3,3261,161,8,33651,26.73,2,66.12,5
M9B5T6,3262,161,17,33668,26.73,5,66.12,11
M9B3A8,3263,161,9,33677,26.73,2,66.12,6
M9B5V5,3264,161,6,33683,26.73,2,66.11,4
M4N2R6,3265,161,11,33694,23.87,3,78.50,9
M9B5V3,3266,161,1,33695,26.73,0,66.11,1
M4N3A2,3267,161,1,33696,22.67,0,83.68,1
M9B3C9,3268,161,2,33698,26.73,1,66.09,1
M9A2J4,3269,161,2,33700,28.35,1,59.05,1
M6K3N5,3270,161,5,33705,23.94,1,78.16,4
M4N1J3,3271,161,14,33719,22.67,3,83.66,12
L4L2V3,3272,161,6,33725,27.77,2,61.56,4
M4R1Z8,3273,161,3,33728,25.77,1,70.22,2
L4L2V2,3274,161,5,33733,27.77,1,61.55,3
L4L1J2,3275,161,8,33741,27.77,2,61.55,5
L4L2H8,3276,161,20,33761,27.77,6,61.55,12
L4L1J1,3277,161,10,33771,27.77,3,61.55,6
L4L8V5,3278,161,29,33800,27.77,8,61.55,18
M9B3E2,3279,161,2,33802,26.73,1,66.05,1
L4L2L4,3280,161,4,33806,27.77,1,61.54,2
M9A2J9,3281,161,3,33809,28.35,1,59.03,2
M9A1N8,3282,161,8,33817,28.35,2,59.02,5
M4N2Z9,3283,161,1,33818,22.66,0,83.67,1
M4N3E6,3284,161,5,33823,22.66,1,83.67,4
M9A1P1,3285,161,4,33827,28.35,1,59.02,2
M9A1N2,3286,161,14,33841,28.35,4,59.02,8
M9A1P4,3287,161,13,33854,28.35,4,59.02,8
M9A1R4,3288,161,12,33866,28.35,3,59.02,7
M9B3M7,3289,161,7,33873,28.35,2,59.01,4
M9A1P6,3290,161,10,33883,28.35,3,59.01,6
M4N1C7,3291,161,8,33891,22.66,2,83.66,7
M9A2J3,3292,161,2,33893,28.35,1,59.01,1
M4N1E2,3293,161,12,33905,22.66,3,83.66,10
M4N1K8,3294,161,17,33922,22.66,4,83.66,14
M5M3V6,3295,161,3,33925,27.30,1,63.56,2
M9A2J2,3296,161,2,33927,28.35,1,59.01,1
M4N1C6,3297,161,11,33938,22.66,2,83.66,9
M4N1N9,3298,161,20,33958,22.66,5,83.66,17
M9A1R6,3299,161,4,33962,28.35,1,59.01,2
M4N1J2,3300,161,17,33979,22.66,4,83.66,14
M4N1G6,3301,161,11,33990,22.66,2,83.66,9
M9A1P5,3302,161,13,34003,28.35,4,59.01,8
M4N1G7,3303,161,12,34015,22.66,3,83.66,10
M4N1K7,3304,161,21,34036,22.66,5,83.66,18
M9A1N9,3305,161,6,34042,28.35,2,59.01,4
M4N3A4,3306,161,3,34045,22.66,1,83.66,3
M4N3E8,3307,161,3,34048,22.66,1,83.66,3
M4N1B2,3308,161,7,34055,22.66,2,83.66,6
M4N3G3,3309,161,1,34056,22.66,0,83.65,1
M9A2K2,3310,161,2,34058,28.35,1,59.00,1
M4N2Z8,3311,161,5,34063,22.66,1,83.65,4
M4N3A7,3312,161,7,34070,22.66,2,83.65,6
M9A1N4,3313,161,9,34079,28.35,3,59.00,5
M4N1E3,3314,161,10,34089,22.66,2,83.65,8
M9A2J5,3315,161,2,34091,28.35,1,59.00,1
M4N3A3,3316,161,2,34093,22.66,0,83.64,2
M4N1A9,3317,161,4,34097,22.66,1,83.64,3
M4N3E7,3318,161,2,34099,22.66,0,83.64,2
M4N3A8,3319,161,2,34101,22.66,0,83.64,2
M9A2J6,3320,161,2,34103,28.35,1,58.99,1
M5M3W1,3321,161,4,34107,27.30,1,63.53,3
M5M3V4,3322,161,5,34112,27.30,1,63.52,3
M5M3V8,3323,161,7,34119,27.30,2,63.52,4
M5M3V1,3324,161,5,34124,27.30,1,63.52,3
M5M3V2,3325,161,5,34129,27.30,1,63.52,3
M9A2K3,3326,161,1,34130,28.35,0,58.97,1
M5M2E8,3327,161,4,34134,27.30,1,63.52,3
M5M2H8,3328,161,3,34137,27.30,1,63.51,2
M4N3A9,3329,161,1,34138,22.66,0,83.61,1
M4N3A1,3330,161,1,34139,22.66,0,83.61,1
M5M1P8,3331,161,20,34159,27.27,5,63.62,13
M5M1T4,3332,161,17,34176,27.27,5,63.61,11
L4L2L5,3333,161,7,34183,27.71,2,61.68,4
L4J2G8,3334,161,2,34185,27.24,1,63.70,1
L4J7P1,3335,161,6,34191,27.24,2,63.69,4
L4J4K6,3336,161,7,34198,27.24,2,63.69,4
L4J2H1,3337,161,9,34207,27.24,2,63.69,6
M4K3E8,3338,161,3,34210,24.73,1,74.56,2
L4J1B9,3339,161,13,34223,27.24,4,63.69,8
L4J4X8,3340,161,18,34241,27.24,5,63.69,11
L4J1C1,3341,161,13,34254,27.24,4,63.69,8
L4J5E1,3342,161,10,34264,27.24,3,63.69,6
M4K1W8,3343,161,9,34273,24.73,2,74.56,7
L4J4X7,3344,161,8,34281,27.24,2,63.68,5
L4J4Y1,3345,161,11,34292,27.24,3,63.68,7
M4K1W3,3346,161,17,34309,24.73,4,74.56,13
M4K3L7,3347,161,4,34313,24.73,1,74.56,3
M8X1S8,3348,161,1,34314,27.08,0,64.37,1
M6B4G1,3349,161,1,34315,25.99,0,69.10,1
L4J2J5,3350,161,4,34319,27.24,1,63.68,3
M4K1Y4,3351,161,9,34328,24.73,2,74.55,7
M4K1X9,3352,161,17,34345,24.73,4,74.55,13
M4K1Y5,3353,161,9,34354,24.73,2,74.55,7
L4J2J3,3354,161,4,34358,27.24,1,63.67,3
L4J4X6,3355,161,16,34374,27.15,4,64.06,10
M6B2H3,3356,161,14,34388,25.99,4,69.08,10
M6B1Z4,3357,161,12,34400,25.99,3,69.08,8
M6B1Z5,3358,161,13,34413,25.99,3,69.08,9
M6B2C4,3359,161,20,34433,25.99,5,69.08,14
M6B2C3,3360,161,19,34452,25.99,5,69.08,13
L3T1K9,3361,161,26,34478,27.51,7,62.46,16
L4J7L8,3362,161,10,34488,27.04,3,64.49,6
L4J3B9,3363,161,35,34523,26.70,9,65.96,23
M6J2G9,3364,161,6,34529,24.18,1,76.88,5
L3T6Y4,3365,161,9,34538,25.58,2,70.80,6
L4L3E7,3366,161,1,34539,26.22,0,67.98,1
M9A4N1,3367,161,22,34561,27.29,6,63.33,14
M9B2Z7,3368,161,3,34564,27.12,1,64.06,2
M9B3C4,3369,161,4,34568,27.12,1,64.05,3
L4L7H4,3370,161,3,34571,26.22,1,67.95,2
M9B4M3,3371,161,8,34579,27.12,2,64.05,5
L4L3E9,3372,161,5,34584,26.22,1,67.95,3
L4L8V4,3373,161,7,34591,26.22,2,67.94,5
M9B3G8,3374,161,4,34595,27.12,1,64.05,3
L4K4S8,3375,161,63,34658,26.49,17,66.77,42
M9B5T2,3376,161,7,34665,27.12,2,64.04,4
M9B3G9,3377,161,4,34669,27.12,1,64.04,3
M9B5T3,3378,161,9,34678,27.12,2,64.03,6
M9B2Z5,3379,161,11,34689,27.12,3,64.03,7
M9B5Y7,3380,161,8,34697,27.12,2,64.03,5
M9B5T4,3381,161,8,34705,27.12,2,64.03,5
M9B6A4,3382,161,5,34710,27.12,1,64.03,3
L4J1B6,3383,161,9,34719,26.22,2,67.93,6
L4J1E3,3384,161,7,34726,26.22,2,67.93,5
L4J7L9,3385,161,14,34740,26.22,4,67.92,10
L4J7L7,3386,161,10,34750,26.22,3,67.92,7
L4J2H2,3387,161,5,34755,26.22,1,67.92,3
L4J7L3,3388,161,10,34765,26.22,3,67.92,7
L4J4X5,3389,161,10,34775,26.22,3,67.92,7
M9B5Y4,3390,161,10,34785,27.12,3,64.02,6
L4J2E7,3391,161,3,34788,26.22,1,67.92,2
L4J1B7,3392,161,18,34806,26.22,5,67.92,12
L4J1B5,3393,161,8,34814,26.22,2,67.92,5
L4J8P5,3394,161,1,34815,26.22,0,67.92,1
L4J3L8,3395,161,17,34832,26.22,4,67.92,12
L4J7L4,3396,161,10,34842,26.22,3,67.92,7
L4J1E1,3397,161,8,34850,26.22,2,67.92,5
L4J2E8,3398,161,3,34853,26.22,1,67.92,2
L4J1E4,3399,161,6,34859,26.22,2,67.91,4
L4J8P6,3400,161,8,34867,26.22,2,67.91,5
M4B1P4,3401,161,29,34896,28.34,8,58.72,17
M9A4E8,3402,161,1,34897,28.49,0,58.06,1
M9A4B8,3403,161,1,34898,28.49,0,58.06,1
L4J2B2,3404,161,2,34900,26.22,1,67.89,1
L4J8R1,3405,161,1,34901,26.22,0,67.87,1
M5P2H9,3406,161,32,34933,26.08,8,68.47,22
M9A4C1,3407,161,2,34935,28.07,1,59.84,1
M9A4E4,3408,161,6,34941,28.49,2,58.02,3
M9A4G1,3409,161,8,34949,28.49,2,58.02,5
M9A4E7,3410,161,9,34958,28.49,3,58.02,5
M9A4E6,3411,161,13,34971,28.49,4,58.01,8
M9A4B5,3412,161,16,34987,28.49,5,58.01,9
M9A4E9,3413,161,9,34996,28.49,3,58.01,5
M9A4N9,3414,161,4,35000,28.49,1,58.01,2
M9A4P2,3415,161,8,35008,28.49,2,58.01,5
M9A4N7,3416,161,12,35020,28.49,3,58.00,7
M9A4N8,3417,161,7,35027,28.49,2,58.00,4
M9A4E2,3418,161,7,35034,28.49,2,58.00,4
M9A4E5,3419,161,4,35038,28.49,1,57.99,2
M9A4B9,3420,161,2,35040,28.49,1,57.99,1
M9A4P1,3421,161,3,35043,28.49,1,57.98,2
M9A4P3,3422,161,2,35045,28.49,1,57.98,1
M4B1R4,3423,161,27,35072,28.46,8,58.09,16
M4B1R1,3424,161,16,35088,28.46,5,58.09,9
M9A3M5,3425,161,5,35093,26.79,1,65.32,3
M4B2Y6,3426,161,6,35099,28.46,2,58.08,3
M4N1J7,3427,161,8,35107,23.21,2,80.80,6
M4G2W3,3428,161,21,35128,24.60,5,74.76,16
M4N1J8,3429,161,11,35139,23.21,3,80.78,9
M4W2W5,3430,161,1,35140,23.91,0,77.75,1
L4J7J8,3431,161,17,35157,25.21,4,72.12,12
L4J7H5,3432,161,18,35175,25.21,5,72.11,13
M4W2W1,3433,161,7,35182,23.91,2,77.74,5
M4W2W7,3434,161,2,35184,23.91,0,77.74,2
L3T6T9,3435,161,7,35191,25.95,2,68.90,5
M4W2C4,3436,161,2,35193,23.91,0,77.74,2
M4W1X8,3437,161,12,35205,23.91,3,77.74,9
M4W3B3,3438,161,10,35215,23.91,2,77.74,8
M9A4E3,3439,161,8,35223,28.45,2,58.06,5
L3T6V3,3440,161,10,35233,25.95,3,68.90,7
M4W3B2,3441,161,22,35255,23.91,5,77.73,17
M4W2A7,3442,161,21,35276,23.91,5,77.73,16
M4W2C3,3443,161,6,35282,23.91,1,77.73,5
M4W2B9,3444,161,4,35286,23.91,1,77.73,3
M4W3B4,3445,161,26,35312,23.91,6,77.73,20
M4W2A8,3446,161,15,35327,23.91,4,77.73,12
M4W1Y4,3447,161,27,35354,23.91,6,77.73,21
M4W1X7,3448,161,15,35369,23.91,4,77.73,12
M9A2M3,3449,161,16,35385,26.79,4,65.25,10
M4W1Y3,3450,161,15,35400,23.91,4,77.73,12
L3T6V4,3451,161,11,35411,25.95,3,68.89,8
M4W1V4,3452,161,12,35423,23.91,3,77.72,9
L3T7M1,3453,161,17,35440,25.95,4,68.89,12
M4W2W4,3454,160,1,35441,23.91,0,77.68,1
L4J1H2,3455,160,2,35443,26.17,1,67.88,1
L4L2S3,3456,160,7,35450,27.67,2,61.36,4
M4N3R1,3457,160,39,35489,26.82,10,65.03,25
L4J2V2,3458,160,5,35494,28.13,1,59.35,3
M5N1H3,3459,160,5,35499,27.30,1,62.94,3
L4J2R7,3460,160,11,35510,28.13,3,59.34,7
M5N2J4,3461,160,15,35525,27.30,4,62.93,9
L4J3H5,3462,160,13,35538,28.13,4,59.34,8
L4J2R8,3463,160,7,35545,28.13,2,59.34,4
L4J2P3,3464,160,16,35561,28.13,5,59.33,9
L4J2N7,3465,160,43,35604,28.13,12,59.33,26
L4J2S5,3466,160,22,35626,28.13,6,59.33,13
L4J2Y8,3467,160,40,35666,28.13,11,59.33,24
L4J6R9,3468,160,18,35684,28.13,5,59.33,11
L4J6R3,3469,160,18,35702,28.13,5,59.33,11
L4J2P2,3470,160,32,35734,28.13,9,59.33,19
L4J2V3,3471,160,12,35746,28.13,3,59.33,7
M6P3E9,3472,160,10,35756,26.97,3,64.35,6
L4J2V1,3473,160,10,35766,28.13,3,59.33,6
L4J2N8,3474,160,18,35784,28.13,5,59.33,11
L4J6R8,3475,160,18,35802,28.13,5,59.33,11
M6P3G8,3476,160,7,35809,26.97,2,64.35,5
M6P2X2,3477,160,27,35836,26.97,7,64.35,17
M6P2Z2,3478,160,19,35855,26.97,5,64.35,12
L4J2R9,3479,160,4,35859,28.13,1,59.31,2
M5M1P5,3480,160,38,35897,25.95,10,68.74,26
M5M1S9,3481,160,43,35940,25.95,11,68.74,30
M5M3K2,3482,160,2,35942,25.95,1,68.73,1
L4H1E3,3483,160,8,35950,29.62,2,52.77,4
M5M3P2,3484,160,2,35952,26.60,1,65.85,1
M5M3V5,3485,160,2,35954,26.60,1,65.85,1
M5N2P7,3486,160,1,35955,26.39,0,66.75,1
M5N2P5,3487,160,8,35963,26.39,2,66.75,5
M5N1L8,3488,160,27,35990,26.39,7,66.74,18
M5N1M5,3489,160,27,36017,26.39,7,66.74,18
M5N1L9,3490,160,27,36044,26.39,7,66.74,18
M9P3N4,3491,160,1,36045,26.20,0,67.56,1
M5M4J2,3492,160,3,36048,26.80,1,64.96,2
M5M4H8,3493,160,4,36052,26.80,1,64.96,3
M5M1R6,3494,160,4,36056,26.80,1,64.95,3
M8X1S9,3495,160,26,36082,26.35,7,66.90,17
M5M1T9,3496,160,17,36099,26.80,5,64.95,11
M5M3V7,3497,160,8,36107,26.60,2,65.81,5
M6C2Y1,3498,160,14,36121,26.16,4,67.72,9
M5M2H7,3499,160,33,36154,26.60,9,65.81,22
M5M2B3,3500,160,36,36190,26.60,10,65.81,24
M5M2E5,3501,160,33,36223,26.60,9,65.81,22
M5M2H6,3502,160,40,36263,26.60,11,65.81,26
M5M1L7,3503,160,23,36286,26.80,6,64.94,15
M5M2B2,3504,160,37,36323,26.60,10,65.81,24
M5M1Z1,3505,160,37,36360,26.60,10,65.81,24
M5M1W9,3506,160,21,36381,26.80,6,64.94,14
M5M1R7,3507,160,17,36398,26.80,5,64.94,11
M5M2E6,3508,160,37,36435,26.60,10,65.81,24
M5M1N4,3509,160,11,36446,26.80,3,64.94,7
M5M1N5,3510,160,13,36459,26.80,3,64.94,8
M5M1T8,3511,160,15,36474,26.80,4,64.94,10
M5M1X3,3512,160,20,36494,26.80,5,64.94,13
M5M1R3,3513,160,4,36498,26.80,1,64.94,3
M5M1V1,3514,160,21,36519,26.80,6,64.94,14
M5M1L5,3515,160,16,36535,26.80,4,64.94,10
M5M1T7,3516,160,18,36553,26.80,5,64.94,12
M5M1R5,3517,160,4,36557,26.80,1,64.94,3
M5M3P1,3518,160,6,36563,26.60,2,65.80,4
L4J6Y2,3519,160,18,36581,26.52,5,66.14,12
M6S3W9,3520,160,31,36612,26.79,8,64.96,20
M6B1L9,3521,160,1,36613,29.00,0,55.36,1
M5M4E4,3522,160,1,36614,26.80,0,64.88,1
M4G2E6,3523,160,7,36621,27.69,2,61.02,4
M3B1P5,3524,160,5,36626,25.41,1,70.89,4
M3B2H5,3525,160,4,36630,25.41,1,70.89,3
M3B1H5,3526,160,4,36634,25.41,1,70.89,3
M3B2L4,3527,160,2,36636,25.41,1,70.89,1
M3B1N9,3528,160,6,36642,25.41,2,70.88,4
M3B2J1,3529,160,6,36648,25.41,2,70.88,4
M3B1P1,3530,160,6,36654,25.41,2,70.88,4
M3B3S4,3531,160,5,36659,25.41,1,70.88,4
M4B1R8,3532,160,41,36700,28.41,12,57.88,24
M3B2L5,3533,160,5,36705,25.41,1,70.88,4
M3B2H4,3534,160,4,36709,25.41,1,70.88,3
M3B2E5,3535,160,38,36747,25.41,10,70.88,27
M3B2J2,3536,160,36,36783,25.41,9,70.88,26
M3B2H6,3537,160,11,36794,25.41,3,70.88,8
M3B1N8,3538,160,30,36824,25.41,8,70.88,21
M3B1M9,3539,160,17,36841,25.41,4,70.88,12
M3B2J3,3540,160,20,36861,25.41,5,70.88,14
M3B2E4,3541,160,21,36882,25.41,5,70.87,15
M3B1H6,3542,160,10,36892,25.41,3,70.87,7
M3B1P6,3543,160,12,36904,25.41,3,70.87,9
M3B1P3,3544,160,5,36909,25.41,1,70.87,4
M3B1M5,3545,160,13,36922,25.41,3,70.87,9
M3B1N7,3546,160,36,36958,25.41,9,70.87,26
M3B1L3,3547,160,5,36963,25.41,1,70.87,4
M3B2E6,3548,160,5,36968,25.41,1,70.87,4
M3B1M6,3549,160,7,36975,25.41,2,70.87,5
M3B1L4,3550,160,4,36979,25.41,1,70.87,3
M3B2C8,3551,160,4,36983,25.41,1,70.86,3
M3H1E8,3552,160,5,36988,27.45,1,62.03,3
M3B2H9,3553,160,6,36994,25.41,2,70.86,4
M6S2G2,3554,160,12,37006,28.45,3,57.69,7
M3H1G1,3555,160,1,37007,27.45,0,62.01,1
M6S2B4,3556,160,17,37024,28.45,5,57.68,10
M6S2B5,3557,160,16,37040,28.45,5,57.68,9
M9A4R2,3558,160,11,37051,26.31,3,66.94,7
M6S4G2,3559,160,11,37062,28.45,3,57.67,6
M6S2B6,3560,160,12,37074,28.45,3,57.67,7
M5M4E1,3561,160,1,37075,26.78,0,64.89,1
M3H1E6,3562,160,4,37079,27.45,1,61.97,2
M3H1E9,3563,160,6,37085,27.45,2,61.97,4
M3H1E7,3564,160,5,37090,27.45,1,61.96,3
M4M1R7,3565,160,22,37112,24.45,5,74.92,16
M4M1W9,3566,160,9,37121,24.45,2,74.91,7
L4J4V9,3567,160,11,37132,26.47,3,66.13,7
L3T6X2,3568,160,17,37149,25.06,4,72.23,12
M5M2J1,3569,160,17,37166,28.02,5,59.40,10
L3T5K2,3570,160,30,37196,26.41,8,66.36,20
L3T5K1,3571,160,34,37230,26.41,9,66.36,23
M5M2E9,3572,160,24,37254,28.01,7,59.40,14
L3T5S3,3573,160,3,37257,26.40,1,66.37,2
M2N4V3,3574,160,13,37270,26.81,3,64.59,8
M4W2V3,3575,160,7,37277,25.58,2,69.92,5
M4W1K6,3576,160,2,37279,25.58,1,69.92,1
L3T7J1,3577,160,8,37287,24.84,2,73.12,6
M2N2X2,3578,160,13,37300,26.81,3,64.59,8
M4W2S9,3579,160,6,37306,25.58,2,69.91,4
M4W2T8,3580,160,9,37315,25.58,2,69.91,6
L3T5P7,3581,160,17,37332,26.40,4,66.36,11
M4W1M4,3582,160,16,37348,25.58,4,69.91,11
M4W1K5,3583,160,4,37352,25.58,1,69.91,3
M4W2Y6,3584,160,5,37357,25.58,1,69.91,3
M4W1N9,3585,160,10,37367,25.58,3,69.90,7
M4W2T9,3586,160,6,37373,25.58,2,69.90,4
L3T7G7,3587,160,9,37382,24.84,2,73.11,7
M4W2Y9,3588,160,18,37400,25.58,5,69.90,13
L3T7G9,3589,160,17,37417,24.84,4,73.11,12
L3T7H3,3590,160,9,37426,24.84,2,73.11,7
L3T7B1,3591,160,16,37442,24.84,4,73.11,12
L3T7H4,3592,160,17,37459,24.84,4,73.11,12
L3T7B3,3593,160,10,37469,24.84,2,73.11,7
L3T7C4,3594,160,10,37479,24.84,2,73.11,7
L3T7B4,3595,160,17,37496,24.84,4,73.11,12
L3T7A9,3596,160,17,37513,24.84,4,73.10,12
M4W2Y7,3597,160,2,37515,25.58,1,69.90,1
L3T7B2,3598,160,9,37524,24.84,2,73.10,7
M4W1K4,3599,160,11,37535,25.58,3,69.90,8
L3T7A8,3600,160,9,37544,24.84,2,73.10,7
L3T7J2,3601,160,10,37554,24.84,2,73.10,7
M5M1P2,3602,160,38,37592,25.01,10,72.35,27
M3H1C2,3603,160,1,37593,27.46,0,61.73,1
M6S3V1,3604,160,6,37599,28.76,2,56.09,3
M3H1C6,3605,160,5,37604,27.46,1,61.72,3
M3H1C4,3606,160,5,37609,27.46,1,61.72,3
M3H1K7,3607,160,10,37619,27.46,3,61.71,6
M3H1K6,3608,160,13,37632,27.46,4,61.71,8
M3H1K2,3609,160,13,37645,27.46,4,61.71,8
M3H1K5,3610,160,12,37657,27.46,3,61.71,7
M3H1K4,3611,160,12,37669,27.46,3,61.71,7
M3H1C3,3612,160,3,37672,27.46,1,61.71,2
M3H1L6,3613,160,13,37685,27.46,4,61.71,8
M3H1P7,3614,160,5,37690,27.46,1,61.71,3
M3H1L5,3615,160,11,37701,27.46,3,61.70,7
M3H1L3,3616,160,11,37712,27.46,3,61.70,7
M3H1L4,3617,160,10,37722,27.46,3,61.70,6
L4L2L3,3618,160,16,37738,27.43,4,61.82,10
M4K1Y2,3619,160,32,37770,24.49,8,74.56,24
M3H1B9,3620,160,1,37771,27.46,0,61.68,1
M3H1P6,3621,160,1,37772,27.46,0,61.67,1
M9B3C3,3622,160,2,37774,26.91,1,64.05,1
M9B2Z6,3623,160,4,37778,26.91,1,64.05,3
M9B4M1,3624,160,10,37788,26.91,3,64.04,6
L3T7B7,3625,160,17,37805,25.83,4,68.70,12
L4L8T3,3626,160,12,37817,27.47,3,61.55,7
M6B1X7,3627,160,14,37831,26.64,4,65.14,9
L4L2H9,3628,160,9,37840,27.47,2,61.55,6
M6H2K2,3629,160,6,37846,24.37,1,74.97,4
M6B2H4,3630,160,14,37860,25.73,4,69.08,10
M6B2C2,3631,160,15,37875,25.73,4,69.08,10
M6B2C1,3632,160,14,37889,25.73,4,69.08,10
M6B2H5,3633,160,14,37903,25.73,4,69.08,10
L4L4G8,3634,160,1,37904,27.47,0,61.54,1
M6B2K8,3635,160,15,37919,25.73,4,69.08,10
M2J2J6,3636,160,7,37926,25.21,2,71.33,5
M2N1E7,3637,160,23,37949,27.40,6,61.80,14
L3T7E7,3638,160,13,37962,26.37,3,66.26,9
L3T7H2,3639,160,17,37979,25.15,4,71.54,12
M2N2L4,3640,160,1,37980,27.40,0,61.74,1
M8X2P3,3641,160,12,37992,26.95,3,63.66,8
M3A3C2,3642,160,5,37997,27.37,1,61.78,3
M4V3C5,3643,160,1,37998,23.77,0,77.37,1
M4K3E7,3644,160,2,38000,24.41,0,74.59,1
M4K3E9,3645,160,2,38002,24.41,0,74.58,1
M4K3L8,3646,160,2,38004,24.41,0,74.58,1
L4L7W1,3647,160,11,38015,26.23,3,66.69,7
M2P1K1,3648,160,18,38033,25.39,5,70.33,13
L4L7T1,3649,160,8,38041,26.23,2,66.69,5
L3T7G6,3650,160,17,38058,25.11,4,71.54,12
M2P1T4,3651,160,4,38062,25.39,1,70.32,3
M9A1N3,3652,160,17,38079,28.00,5,59.01,10
M9A1L9,3653,160,16,38095,28.00,4,59.01,9
M9A1P7,3654,160,11,38106,28.00,3,59.01,6
M4K3L5,3655,160,3,38109,24.41,1,74.57,2
L4L7S1,3656,160,10,38119,26.23,3,66.68,7
M9B3M8,3657,160,7,38126,28.00,2,59.01,4
M9A1N6,3658,160,1,38127,28.00,0,59.01,1
M4K1Y3,3659,160,31,38158,24.41,8,74.56,23
M6S4C4,3660,160,11,38169,27.66,3,60.47,7
M6S2B3,3661,160,9,38178,27.66,2,60.47,5
L3T5L5,3662,160,16,38194,26.30,4,66.36,11
M6S2B2,3663,160,7,38201,27.66,2,60.46,4
M6S4G3,3664,160,14,38215,27.66,4,60.46,8
M6S2E8,3665,160,8,38223,27.66,2,60.46,5
M5M1Z3,3666,160,13,38236,27.15,4,62.66,8
L4L5J6,3667,160,10,38246,25.62,3,69.28,7
L4L5J7,3668,160,16,38262,25.62,4,69.28,11
M5M2B4,3669,160,13,38275,27.15,4,62.65,8
L4L5K7,3670,160,10,38285,25.62,3,69.27,7
L4L5K4,3671,160,10,38295,25.62,3,69.27,7
M5N2G2,3672,160,7,38302,25.45,2,70.00,5
M4G2W6,3673,160,9,38311,24.35,2,74.76,7
L3T2M3,3674,160,26,38337,27.19,7,62.46,16
L3T1L1,3675,160,23,38360,27.19,6,62.46,14
M4W2Z9,3676,160,1,38361,25.51,0,69.72,1
M5N2L1,3677,160,23,38384,27.51,6,61.04,14
M5N2K5,3678,160,22,38406,27.51,6,61.03,13
M3A3L8,3679,159,22,38428,27.32,6,61.78,14
M3A3L7,3680,159,33,38461,27.32,9,61.78,20
M4W2Z8,3681,159,4,38465,25.51,1,69.60,3
M4W1K1,3682,159,10,38475,25.51,3,69.60,7
M4W1K7,3683,159,3,38478,25.51,1,69.60,2
M4W3A5,3684,159,2,38480,25.51,1,69.56,1
M4V1V5,3685,159,7,38487,26.20,2,66.56,5
M5M3K4,3686,159,3,38490,25.69,1,68.75,2
M5M1S8,3687,159,55,38545,25.69,14,68.75,38
M5M1W2,3688,159,38,38583,25.69,10,68.74,26
M5M3N5,3689,159,8,38591,25.69,2,68.74,5
M5M3N4,3690,159,3,38594,25.69,1,68.71,2
M5R2Y3,3691,159,31,38625,23.75,7,77.11,24
M5M1Z2,3692,159,15,38640,27.12,4,62.49,9
M5M1W5,3693,159,16,38656,27.12,4,62.49,10
M9B1S8,3694,159,1,38657,26.79,0,63.90,1
M4R1G6,3695,159,62,38719,25.37,16,70.00,43
L4J7S8,3696,159,41,38760,26.64,11,64.48,26
L4J3N8,3697,159,51,38811,24.99,13,71.60,37
M9A2L8,3698,159,3,38814,26.48,1,65.14,2
L4J1H4,3699,159,3,38817,26.14,1,66.59,2
M6P1V1,3700,159,11,38828,26.41,3,65.40,7
M6P1R6,3701,159,12,38840,26.41,3,65.39,8
M5V0B5,3702,159,82,38922,28.54,23,56.14,46
M9A4A6,3703,159,7,38929,26.54,2,64.78,5
L4J7S2,3704,159,37,38966,26.46,10,65.09,24
M9P3H2,3705,159,1,38967,26.20,0,66.22,1
M6P3G4,3706,159,21,38988,26.63,6,64.35,14
M6P3G7,3707,159,9,38997,26.63,2,64.35,6
M6P2W9,3708,159,50,39047,26.63,13,64.35,32
M6P1G7,3709,159,16,39063,26.63,4,64.35,10
M6P2Z1,3710,159,2,39065,26.63,1,64.34,1
M6P1G8,3711,159,18,39083,26.63,5,64.34,12
M6P2X1,3712,159,3,39086,26.63,1,64.33,2
M9A1Y4,3713,159,1,39087,27.68,0,59.78,1
M4N1A7,3714,159,21,39108,24.97,5,71.52,15
M9B2B4,3715,159,2,39110,27.26,1,61.60,1
M9A1Y2,3716,159,1,39111,27.68,0,59.78,1
M6P2V1,3717,159,2,39113,26.63,1,64.32,1
M9A2A1,3718,159,2,39115,27.68,1,59.76,1
M9A1Z7,3719,159,2,39117,27.68,1,59.75,1
M9A2B5,3720,159,1,39118,27.68,0,59.75,1
M9A2A2,3721,159,2,39120,27.68,1,59.75,1
M9A2N7,3722,159,2,39122,27.68,1,59.74,1
M9A1Z8,3723,159,3,39125,27.68,1,59.74,2
M9A1Z9,3724,159,2,39127,27.68,1,59.74,1
M9B5A4,3725,159,11,39138,27.26,3,61.56,7
M9B2E7,3726,159,3,39141,27.26,1,61.56,2
M9B5A8,3727,159,15,39156,27.26,4,61.56,9
M9P2E3,3728,159,5,39161,26.20,1,66.15,3
M9A2T6,3729,159,7,39168,27.68,2,59.74,4
M9A2N5,3730,159,11,39179,27.68,3,59.74,7
M9A2R1,3731,159,10,39189,27.68,3,59.73,6
M9B4P8,3732,159,17,39206,27.26,5,61.55,10
M9B2E1,3733,159,8,39214,27.26,2,61.55,5
M9A2A4,3734,159,6,39220,27.68,2,59.73,4
M9A1Z3,3735,159,12,39232,27.68,3,59.73,7
M9B4L3,3736,159,4,39236,27.26,1,61.55,2
L3T7G8,3737,159,17,39253,25.75,4,68.10,12
M9A2T5,3738,159,26,39279,27.68,7,59.73,16
M9B4L1,3739,159,13,39292,27.26,4,61.55,8
M9A2T4,3740,159,21,39313,27.68,6,59.73,13
M9B5A5,3741,159,9,39322,27.26,2,61.55,6
M9B2C9,3742,159,9,39331,27.26,2,61.55,6
M9B5A6,3743,159,10,39341,27.26,3,61.55,6
M9A2R4,3744,159,17,39358,27.68,5,59.73,10
M9B2E8,3745,159,10,39368,27.26,3,61.55,6
M9A2P6,3746,159,10,39378,27.68,3,59.73,6
M4S2J7,3747,159,88,39466,26.50,23,64.84,57
M9B2L7,3748,159,10,39476,27.26,3,61.55,6
M9A2A5,3749,159,8,39484,27.68,2,59.73,5
M9B5A7,3750,159,15,39499,27.26,4,61.55,9
M9A2A3,3751,159,9,39508,27.68,2,59.73,5
M9B2G1,3752,159,5,39513,27.26,1,61.55,3
M9B4L4,3753,159,11,39524,27.26,3,61.55,7
M9B2E6,3754,159,10,39534,27.26,3,61.54,6
M9R1E9,3755,159,22,39556,29.95,7,49.89,11
M6S5A4,3756,159,30,39586,26.49,8,64.88,19
M9A2B6,3757,159,1,39587,27.68,0,59.72,1
L3T7C2,3758,159,14,39601,25.83,4,67.73,9
M9P2G3,3759,159,8,39609,26.20,2,66.13,5
M9B4R5,3760,159,5,39614,27.26,1,61.53,3
M9B4R3,3761,159,3,39617,27.26,1,61.53,2
M9A1S4,3762,159,1,39618,25.70,0,68.28,1
M9B2G2,3763,159,3,39621,27.26,1,61.51,2
L3T6Y7,3764,159,8,39629,25.26,2,70.17,6
M4S1T9,3765,159,42,39671,25.16,11,70.58,30
M5N1H5,3766,159,4,39675,27.61,1,59.94,2
M3H1M5,3767,159,7,39682,27.03,2,62.45,4
M3H1G5,3768,159,9,39691,27.03,2,62.45,6
M3H1C8,3769,159,13,39704,27.03,4,62.45,8
M5N2K7,3770,159,21,39725,27.61,6,59.93,13
M3H1M7,3771,159,7,39732,27.03,2,62.45,4
M3H1G4,3772,159,12,39744,27.03,3,62.44,7
M3H1C7,3773,159,21,39765,27.03,6,62.44,13
M3H1P3,3774,159,6,39771,27.03,2,62.44,4
M3H1M4,3775,159,1,39772,27.03,0,62.44,1
M3H1B4,3776,159,21,39793,27.03,6,62.43,13
M3H1G9,3777,159,8,39801,27.03,2,62.43,5
L3T7C7,3778,159,10,39811,26.24,3,65.84,7
L3T7H1,3779,159,9,39820,25.72,2,68.09,6
M5R2Z9,3780,159,16,39836,25.66,4,68.33,11
M5R3A7,3781,159,14,39850,25.66,4,68.32,10
M5M4J4,3782,159,1,39851,27.70,0,59.47,1
L3T7C3,3783,159,9,39860,25.57,2,68.70,6
M9B2J2,3784,159,2,39862,26.61,1,64.17,1
M3H6A9,3785,159,19,39881,27.15,5,61.82,12
M6S4G4,3786,159,5,39886,28.10,1,57.70,3
M6B1R6,3787,159,23,39909,26.38,6,65.15,15
M6B1N2,3788,159,17,39926,26.38,4,65.14,11
M6B1M9,3789,159,46,39972,26.38,12,65.14,30
M6B1R5,3790,159,23,39995,26.38,6,65.14,15
M5M2K8,3791,159,3,39998,27.70,1,59.42,2
M6S1Z9,3792,159,3,40001,28.10,1,57.68,2
M9B2H8,3793,159,2,40003,26.61,1,64.13,1
M5M4G1,3794,159,6,40009,27.70,2,59.40,4
M5M2G3,3795,159,33,40042,27.70,9,59.40,20
M5M2L1,3796,159,22,40064,27.70,6,59.40,13
M5M2G2,3797,159,8,40072,27.70,2,59.40,5
M5M2L2,3798,159,22,40094,27.70,6,59.40,13
M5M2B8,3799,159,35,40129,27.70,10,59.40,21
M4R1S3,3800,159,17,40146,28.90,5,54.20,9
M5M4C4,3801,159,10,40156,27.70,3,59.40,6
M5M2J3,3802,159,6,40162,27.70,2,59.40,4
M5M2B6,3803,159,20,40182,27.70,6,59.40,12
M5M2G5,3804,159,6,40188,27.70,2,59.40,4
M5M4C8,3805,159,8,40196,27.70,2,59.40,5
M5M4E9,3806,159,5,40201,27.70,1,59.40,3
M4R1T1,3807,159,18,40219,28.90,5,54.20,10
M5M2M7,3808,159,18,40237,27.70,5,59.40,11
M4R1S5,3809,159,12,40249,28.90,3,54.20,7
M5M4G2,3810,159,4,40253,27.70,1,59.39,2
M5M4C3,3811,159,2,40255,27.70,1,59.39,1
M5M2P4,3812,159,6,40261,27.70,2,59.39,4
M5M2J4,3813,159,3,40264,27.70,1,59.39,2
M5M2G4,3814,159,4,40268,27.70,1,59.39,2
M5M4C9,3815,159,6,40274,27.70,2,59.38,4
M9B2C8,3816,159,1,40275,26.61,0,64.11,1
M9B3M6,3817,159,23,40298,26.61,6,64.09,15
M9B2C6,3818,159,16,40314,26.61,4,64.09,10
M9B4W8,3819,159,30,40344,26.61,8,64.09,19
M9B4Y3,3820,159,8,40352,26.61,2,64.09,5
M9B4W7,3821,159,22,40374,26.61,6,64.09,14
M9B2H6,3822,159,1,40375,26.61,0,64.09,1
M5M4G4,3823,159,1,40376,27.70,0,59.36,1
M4R1T8,3824,159,2,40378,28.90,1,54.16,1
M9A3W2,3825,159,12,40390,28.64,3,55.27,7
L4J7V9,3826,159,46,40436,28.18,13,57.26,26
M8Y1X1,3827,159,1,40437,26.32,0,65.30,1
M4R2A9,3828,159,5,40442,26.39,1,64.99,3
M4P1W4,3829,159,7,40449,27.66,2,59.47,4
M9B1L6,3830,159,9,40458,25.60,2,68.38,6
M9B1C4,3831,159,8,40466,25.60,2,68.37,5
M9B3R2,3832,159,12,40478,25.60,3,68.37,8
M9B3R6,3833,159,9,40487,25.60,2,68.37,6
M5V0A8,3834,159,163,40650,28.42,46,56.14,92
M5M1W7,3835,159,11,40661,27.50,3,60.12,7
M9A4N4,3836,159,9,40670,27.54,2,59.88,5
L3T3V1,3837,159,1,40671,26.75,0,63.29,1
M6S3T8,3838,159,6,40677,28.41,2,56.09,3
L3T3B5,3839,159,28,40705,26.73,7,63.37,18
M9A1N5,3840,159,16,40721,27.73,4,59.01,9
M9A1M3,3841,159,6,40727,27.73,2,59.01,4
M9A1M4,3842,159,9,40736,27.73,2,59.01,5
M9A1N7,3843,159,6,40742,27.73,2,59.01,4
L3T3T7,3844,159,6,40748,26.75,2,63.25,4
M2J2H4,3845,159,6,40754,24.88,1,71.35,4
M5P3N5,3846,159,2,40756,27.89,1,58.31,1
M2J1K3,3847,159,7,40763,24.88,2,71.34,5
M2J2K1,3848,159,19,40782,24.88,5,71.33,14
M9B2E5,3849,159,3,40785,27.82,1,58.60,2
M2J2J9,3850,159,16,40801,24.88,4,71.33,11
M9A2J8,3851,159,2,40803,27.73,1,58.98,1
M2J2K2,3852,159,7,40810,24.88,2,71.33,5
M2J2G7,3853,159,12,40822,24.88,3,71.33,9
M2J2K4,3854,159,13,40835,24.88,3,71.33,9
M2J1K4,3855,159,13,40848,24.88,3,71.33,9
M2J2H2,3856,159,15,40863,24.88,4,71.32,11
M4T1E6,3857,159,11,40874,20.73,2,89.30,10
M9B3B2,3858,159,24,40898,29.89,7,49.61,12
M9B2H1,3859,159,5,40903,27.82,1,58.58,3
M4V1H7,3860,159,19,40922,23.83,5,75.86,14
M4V1G9,3861,159,4,40926,23.83,1,75.86,3
M2J2E2,3862,159,7,40933,24.88,2,71.31,5
M4V1H4,3863,159,59,40992,23.83,14,75.86,45
L4J7S5,3864,159,35,41027,26.52,9,64.20,22
M9B5C9,3865,159,11,41038,27.82,3,58.57,6
M9B5E7,3866,159,18,41056,27.82,5,58.57,11
M9R1G7,3867,159,2,41058,29.63,1,50.71,1
M2P1R3,3868,159,6,41064,24.63,1,72.37,4
M9P2B2,3869,159,25,41089,27.67,7,59.20,15
M3H1S6,3870,159,3,41092,25.48,1,68.67,2
M9A2M4,3871,159,2,41094,26.79,1,62.99,1
M9B2C1,3872,159,2,41096,27.82,1,58.53,1
M9P2B5,3873,159,3,41099,27.67,1,59.17,2
M4B2Y2,3874,159,4,41103,26.84,1,62.76,3
M4V2C5,3875,159,5,41108,25.00,1,70.71,4
M4V1T3,3876,159,5,41113,25.00,1,70.71,4
M4V1T2,3877,158,23,41136,25.00,6,70.70,16
M4V1V8,3878,158,9,41145,25.00,2,70.70,6
M4V2B3,3879,158,4,41149,25.00,1,70.70,3
M4V1S5,3880,158,2,41151,25.00,1,70.68,1
L3T7E9,3881,158,10,41161,26.23,3,65.35,7
L3T7G5,3882,158,10,41171,26.23,3,65.34,7
L3T7E8,3883,158,9,41180,26.23,2,65.34,6
M9A3N3,3884,158,3,41183,28.27,1,56.50,2
L3T7G1,3885,158,16,41199,26.23,4,65.34,10
L3T7G2,3886,158,9,41208,26.23,2,65.34,6
L3T7E5,3887,158,17,41225,26.23,4,65.34,11
L3T7C1,3888,158,9,41234,26.23,2,65.34,6
L3T7G3,3889,158,16,41250,26.23,4,65.34,10
L3T7C9,3890,158,9,41259,26.23,2,65.33,6
L3T7G4,3891,158,9,41268,26.23,2,65.33,6
L3T7B6,3892,158,10,41278,26.22,3,65.37,7
L3T7B5,3893,158,9,41287,26.22,2,65.37,6
M9A3N8,3894,158,37,41324,28.27,10,56.49,21
M5N1W1,3895,158,7,41331,23.29,2,78.06,5
L3T7C5,3896,158,17,41348,26.22,4,65.36,11
L3T7B9,3897,158,14,41362,26.22,4,65.36,9
L3T7B8,3898,158,9,41371,26.22,2,65.36,6
L3T3C6,3899,158,3,41374,26.68,1,63.34,2
M4J3X5,3900,158,10,41384,26.81,3,62.76,6
M4J2X2,3901,158,49,41433,26.81,13,62.76,31
M4C3B1,3902,158,17,41450,26.81,5,62.76,11
M4J2X5,3903,158,28,41478,26.81,8,62.76,18
M4J2W6,3904,158,16,41494,26.81,4,62.76,10
M4C3B2,3905,158,21,41515,26.81,6,62.76,13
M4C3G7,3906,158,11,41526,26.81,3,62.76,7
M4J2X7,3907,158,8,41534,26.81,2,62.76,5
M9B5Y6,3908,158,5,41539,26.51,1,64.04,3
M9B5Y1,3909,158,6,41545,26.51,2,64.04,4
L4J1H6,3910,158,4,41549,26.12,1,65.73,3
M9B3C6,3911,158,12,41561,26.51,3,64.04,8
M9B6H5,3912,158,14,41575,26.51,4,64.04,9
M9B6G3,3913,158,8,41583,26.51,2,64.04,5
M9B6G7,3914,158,6,41589,26.51,2,64.03,4
M4G2P4,3915,158,17,41606,27.20,5,61.01,10
M4G2S2,3916,158,17,41623,27.20,5,61.01,10
M4G1K7,3917,158,13,41636,27.20,4,61.01,8
M6S4C3,3918,158,8,41644,27.32,2,60.46,5
M6S4C5,3919,158,15,41659,27.32,4,60.46,9
M6S2E7,3920,158,5,41664,27.32,1,60.46,3
M6S2E5,3921,158,2,41666,27.32,1,60.45,1
M9A4N5,3922,158,9,41675,27.57,2,59.32,5
M5M2G1,3923,158,24,41699,27.55,7,59.40,14
M4G2T9,3924,158,5,41704,27.35,1,60.26,3
M4G2S4,3925,158,14,41718,27.35,4,60.25,8
M4G2N2,3926,158,29,41747,27.35,8,60.25,17
M4G3X8,3927,158,8,41755,27.35,2,60.24,5
M4G3X7,3928,158,8,41763,27.35,2,60.24,5
M4G2P6,3929,158,22,41785,27.35,6,60.24,13
M4G2P8,3930,158,27,41812,27.35,7,60.24,16
M4G2S5,3931,158,15,41827,27.35,4,60.24,9
M4G2S6,3932,158,9,41836,27.35,2,60.24,5
M4G3Y8,3933,158,3,41839,27.35,1,60.24,2
M4G2P7,3934,158,17,41856,27.35,5,60.24,10
M4G3Y6,3935,158,11,41867,27.35,3,60.24,7
M5P1G8,3936,158,4,41871,27.80,1,58.28,2
M5P2E3,3937,158,16,41887,27.80,4,58.28,9
M5P1G2,3938,158,7,41894,27.80,2,58.28,4
M5P2J5,3939,158,22,41916,27.80,6,58.28,13
M5P2A7,3940,158,18,41934,27.80,5,58.28,10
M5P1G4,3941,158,7,41941,27.80,2,58.28,4
M5P2C1,3942,158,15,41956,27.80,4,58.28,9
M5P2H6,3943,158,12,41968,27.80,3,58.28,7
M5P2G1,3944,158,17,41985,27.80,5,58.28,10
M5P3M9,3945,158,1,41986,27.80,0,58.28,1
M5P1G6,3946,158,7,41993,27.80,2,58.28,4
M5P2G2,3947,158,14,42007,27.80,4,58.27,8
M5P2H5,3948,158,17,42024,27.80,5,58.27,10
M5P2C2,3949,158,14,42038,27.80,4,58.27,8
M5P1E2,3950,158,1,42039,27.80,0,58.25,1
L3T1C9,3951,158,1,42040,25.42,0,68.56,1
L3T4N9,3952,158,1,42041,25.42,0,68.56,1
M5R3A9,3953,158,7,42048,25.47,2,68.33,5
M9B1Y7,3954,158,1,42049,25.86,0,66.63,1
M2L2Y4,3955,158,60,42109,24.32,15,73.29,44
L3T1G7,3956,158,7,42116,25.42,2,68.48,5
L3T2Y6,3957,158,16,42132,25.42,4,68.48,11
L3T2X3,3958,158,5,42137,25.42,1,68.48,3
L3T1E2,3959,158,12,42149,25.42,3,68.48,8
L3T5S4,3960,158,7,42156,26.37,2,64.36,5
L3T2W9,3961,158,12,42168,25.42,3,68.48,8
L3T1G6,3962,158,10,42178,25.42,3,68.48,7
L3T2Y7,3963,158,9,42187,25.42,2,68.47,6
L3T2W8,3964,158,8,42195,25.42,2,68.47,5
M9B1W4,3965,158,1,42196,25.86,0,66.57,1
L3T2X1,3966,158,5,42201,25.42,1,68.47,3
L3T1E1,3967,158,2,42203,25.42,1,68.47,1
M9B1Y8,3968,158,1,42204,25.86,0,66.55,1
L3T4S6,3969,158,2,42206,25.42,1,68.45,1
M9B1P4,3970,158,2,42208,25.86,1,66.53,1
M9B4W3,3971,158,10,42218,25.86,3,66.53,7
M9B1P2,3972,158,22,42240,25.86,6,66.53,15
M9B4V6,3973,158,14,42254,25.86,4,66.53,9
M9B4S8,3974,158,10,42264,25.86,3,66.53,7
M9B4V9,3975,158,8,42272,25.86,2,66.53,5
M9B1M5,3976,158,13,42285,25.86,3,66.52,9
M6B3E7,3977,158,2,42287,25.99,1,65.95,1
M9B4W1,3978,158,4,42291,25.86,1,66.51,3
M8W2J2,3979,158,5,42296,29.28,1,51.68,3
M8W3V4,3980,158,3,42299,29.28,1,51.68,2
M9A3H7,3981,158,1,42300,27.42,0,59.73,1
M8W4N5,3982,158,8,42308,29.28,2,51.67,4
M8W3V2,3983,158,2,42310,29.28,1,51.67,1
M9R2W2,3984,158,5,42315,26.99,1,61.59,3
M8W4N3,3985,158,11,42326,29.28,3,51.67,6
M8W2K2,3986,158,18,42344,29.28,5,51.66,9
M6B1L5,3987,158,10,42354,25.99,3,65.92,7
M9R2R2,3988,158,15,42369,26.99,4,61.58,9
M6B1H8,3989,158,12,42381,25.99,3,65.92,8
M9R2V3,3990,158,18,42399,26.99,5,61.58,11
M9R2X3,3991,158,3,42402,26.99,1,61.58,2
L3T7K1,3992,158,14,42416,25.62,4,67.52,9
M9A2R3,3993,158,1,42417,26.64,0,63.10,1
M8W2J9,3994,158,3,42420,29.28,1,51.66,2
M6B1L6,3995,158,12,42432,25.99,3,65.91,8
M9B1P9,3996,158,1,42433,25.86,0,66.47,1
M6B1L4,3997,158,10,42443,25.99,3,65.91,7
L4J5C7,3998,158,10,42453,26.90,3,61.96,6
M8W4M8,3999,158,6,42459,29.27,2,51.69,3
M9B2J6,4000,158,2,42461,26.40,1,64.12,1
M8W2H6,4001,158,10,42471,29.27,3,51.68,5
M9A3C6,4002,158,2,42473,27.42,1,59.69,1
M9A1S6,4003,158,2,42475,26.42,1,64.02,1
M9A3E4,4004,158,5,42480,27.42,1,59.69,3
M9A3J3,4005,158,10,42490,27.42,3,59.69,6
M8W2J3,4006,158,3,42493,29.27,1,51.68,2
M9A3G1,4007,158,4,42497,27.42,1,59.69,2
M9A3Z7,4008,158,7,42504,27.42,2,59.69,4
M9A3H4,4009,158,7,42511,27.42,2,59.69,4
M9A3C7,4010,158,9,42520,27.42,2,59.69,5
M9A4A3,4011,158,8,42528,27.42,2,59.69,5
M9A3H9,4012,158,2,42530,27.42,1,59.69,1
M9A3C9,4013,158,14,42544,27.42,4,59.69,8
M9A3Z5,4014,158,5,42549,27.42,1,59.69,3
M9A3X9,4015,158,4,42553,27.42,1,59.69,2
M9A2R5,4016,158,1,42554,26.64,0,63.06,1
M9A4B7,4017,158,10,42564,27.42,3,59.69,6
M9A3E3,4018,158,24,42588,27.42,7,59.68,14
M9A3H5,4019,158,5,42593,27.42,1,59.68,3
M9A3E8,4020,158,23,42616,27.42,6,59.68,14
M8W4N2,4021,158,8,42624,29.27,2,51.67,4
M9A3H6,4022,158,6,42630,27.42,2,59.68,4
M8W2E3,4023,158,6,42636,29.27,2,51.67,3
M9A3Z8,4024,158,5,42641,27.42,1,59.68,3
M9A3Y1,4025,158,5,42646,27.42,1,59.68,3
M9A3E5,4026,158,8,42654,27.42,2,59.68,5
M9A4A2,4027,158,7,42661,27.42,2,59.68,4
M9R2R1,4028,158,1,42662,26.99,0,61.54,1
M9A3H8,4029,158,1,42663,27.42,0,59.68,1
M6B3C5,4030,158,1,42664,25.99,0,65.87,1
M9A4C2,4031,158,2,42666,27.42,1,59.67,1
M9A2C6,4032,158,2,42668,26.64,1,63.05,1
M4K3G1,4033,158,2,42670,25.00,1,70.15,1
M9A2C4,4034,158,16,42686,26.64,4,63.05,10
M9A2C2,4035,158,12,42698,26.64,3,63.05,8
M9A2C9,4036,158,8,42706,26.64,2,63.05,5
M9A2R6,4037,158,25,42731,26.64,7,63.05,16
M4S2W1,4038,158,7,42738,26.18,2,65.04,5
M9A2B3,4039,158,9,42747,26.64,2,63.04,6
M9A2B8,4040,158,9,42756,26.64,2,63.04,6
M9A2T1,4041,158,1,42757,26.64,0,63.04,1
M9A2B7,4042,158,10,42767,26.64,3,63.04,6
M9A2C3,4043,158,15,42782,26.64,4,63.04,9
M9A2R8,4044,158,14,42796,26.64,4,63.04,9
M4K3A6,4045,158,4,42800,25.00,1,70.15,3
M9A2S8,4046,158,3,42803,26.64,1,63.04,2
M4K1Y1,4047,158,17,42820,25.00,4,70.14,12
M9A2T2,4048,158,7,42827,26.64,2,63.04,4
M9A2E1,4049,158,5,42832,26.64,1,63.04,3
M9A2C8,4050,158,9,42841,26.64,2,63.04,6
M9A2R7,4051,158,5,42846,26.64,1,63.03,3
M9A2R2,4052,158,3,42849,26.64,1,63.03,2
M4K1X7,4053,158,32,42881,25.00,8,70.14,22
M9A2E2,4054,158,3,42884,26.64,1,63.03,2
M4K2X8,4055,158,3,42887,25.00,1,70.13,2
M9A4C5,4056,158,1,42888,27.42,0,59.65,1
M9A2C7,4057,158,3,42891,26.64,1,63.02,2
M5M1H2,4058,158,18,42909,26.96,5,61.64,11
M5M1B4,4059,158,11,42920,26.96,3,61.64,7
M5M1L6,4060,158,22,42942,26.96,6,61.63,14
M5M1J9,4061,158,17,42959,26.96,5,61.63,10
M5M1E6,4062,158,17,42976,26.96,5,61.63,10
M5M1J8,4063,158,17,42993,26.96,5,61.63,10
M9A2C5,4064,158,1,42994,26.64,0,63.02,1
M5M1E5,4065,158,15,43009,26.96,4,61.63,9
M6B3C7,4066,158,1,43010,25.99,0,65.83,1
M4K3A8,4067,158,2,43012,25.00,1,70.11,1
M6J3W4,4068,158,63,43075,25.99,16,65.82,41
M9A2S6,4069,158,1,43076,26.64,0,62.98,1
M2L2C5,4070,158,2,43078,26.30,1,64.45,1
M2L1W3,4071,158,1,43079,26.30,0,64.45,1
M3H1H8,4072,158,3,43082,26.76,1,62.45,2
L4J2N5,4073,158,10,43092,27.48,3,59.33,6
L4J2V4,4074,158,8,43100,27.48,2,59.33,5
L4J2N1,4075,158,22,43122,27.48,6,59.33,13
L4J2M2,4076,158,48,43170,27.48,13,59.33,28
L3T7A7,4077,158,16,43186,25.12,4,69.55,11
L4J2M9,4078,158,13,43199,27.48,4,59.33,8
M3H1G3,4079,158,8,43207,26.76,2,62.44,5
L4J2M8,4080,158,10,43217,27.48,3,59.32,6
L4J2P1,4081,158,11,43228,27.48,3,59.32,7
M3H1M3,4082,158,10,43238,26.76,3,62.44,6
M3H1G6,4083,158,6,43244,26.76,2,62.44,4
M3H1G2,4084,158,9,43253,26.76,2,62.44,6
M2L2C2,4085,158,6,43259,26.30,2,64.43,4
M2L2N4,4086,158,2,43261,26.30,1,64.43,1
M2L2N2,4087,158,9,43270,26.30,2,64.42,6
M2L2K7,4088,158,23,43293,26.30,6,64.42,15
M2L2B3,4089,158,14,43307,26.30,4,64.42,9
M3H1P4,4090,158,2,43309,26.76,1,62.43,1
M2L2P3,4091,158,9,43318,26.30,2,64.42,6
M5P2N8,4092,158,11,43329,23.20,3,77.85,9
M3H1M6,4093,158,5,43334,26.76,1,62.43,3
M2L2B4,4094,158,14,43348,26.30,4,64.42,9
M2L2K2,4095,158,10,43358,26.30,3,64.42,6
M4V2V2,4096,158,16,43374,23.31,4,77.37,12
M2L2P1,4097,158,13,43387,26.30,3,64.42,8
M4V2T9,4098,158,8,43395,23.32,2,77.32,6
M3A3B6,4099,158,8,43403,26.90,2,61.81,5
M2L1V7,4100,158,2,43405,26.30,1,64.41,1
M2L1Z4,4101,158,6,43411,26.29,2,64.43,4
M2L1Z2,4102,158,8,43419,26.29,2,64.43,5
M2L2N3,4103,158,5,43424,26.29,1,64.43,3
M2L2C3,4104,158,15,43439,26.29,4,64.43,10
M5R1N6,4105,158,12,43451,23.56,3,76.25,9
M2L2B6,4106,158,11,43462,26.29,3,64.42,7
M2L2E1,4107,158,20,43482,26.29,5,64.42,13
M2L2B9,4108,158,6,43488,26.29,2,64.42,4
M2L2C9,4109,158,11,43499,26.29,3,64.42,7
M2L2C7,4110,158,8,43507,26.29,2,64.42,5
M2L2E2,4111,158,11,43518,26.29,3,64.42,7
M2L2B1,4112,158,10,43528,26.29,3,64.42,6
M2L2B7,4113,158,5,43533,26.29,1,64.42,3
M2L2V5,4114,158,2,43535,26.29,1,64.42,1
M2L2K3,4115,158,9,43544,26.29,2,64.42,6
M2L2B8,4116,158,4,43548,26.29,1,64.42,3
M2L2C1,4117,158,6,43554,26.29,2,64.42,4
M2L2B2,4118,158,4,43558,26.29,1,64.41,3
M2L2C4,4119,158,8,43566,26.29,2,64.41,5
M2L1V9,4120,158,8,43574,26.29,2,64.41,5
M2L2N1,4121,158,6,43580,26.29,2,64.41,4
M5R3B1,4122,158,2,43582,25.62,1,67.29,1
M4M1X1,4123,158,48,43630,23.86,11,74.91,36
M4R1J1,4124,158,9,43639,26.40,2,63.91,6
M4R2B8,4125,158,4,43643,26.40,1,63.91,3
M4R2B7,4126,158,10,43653,26.40,3,63.90,6
M4R1H5,4127,158,42,43695,26.40,11,63.90,27
M4R1J3,4128,158,43,43738,26.40,11,63.90,27
M5N2E9,4129,158,4,43742,26.40,1,63.90,3
L4J4W4,4130,158,18,43760,25.88,5,66.14,12
L4J8J6,4131,158,36,43796,24.85,9,70.59,25
L3T2S1,4132,158,2,43798,25.70,1,66.90,1
L3T7C8,4133,158,13,43811,25.94,3,65.84,9
L3T7E1,4134,158,13,43824,25.94,3,65.84,9
M6S1X3,4135,158,5,43829,27.82,1,57.69,3
M9B6K9,4136,158,46,43875,29.09,13,52.19,24
M6S1W6,4137,158,26,43901,27.82,7,57.68,15
M6S1X6,4138,158,25,43926,27.82,7,57.68,14
M6S1W3,4139,158,4,43930,27.82,1,57.68,2
M6S1X9,4140,158,45,43975,27.82,13,57.68,26
L3T4R9,4141,158,39,44014,25.70,10,66.86,26
L3T1W2,4142,158,8,44022,25.70,2,66.86,5
M4W2C5,4143,158,21,44043,21.79,5,83.80,18
M6S1X5,4144,158,23,44066,27.82,6,57.68,13
M6S4K6,4145,158,35,44101,27.82,10,57.68,20
L3T2R2,4146,158,2,44103,25.70,1,66.86,1
L3T4R7,4147,158,3,44106,25.70,1,66.85,2
M6S1T2,4148,158,2,44108,26.55,1,63.17,1
M4R1X8,4149,158,1,44109,26.12,0,65.03,1
L3T2R3,4150,158,3,44112,25.70,1,66.85,2
M6S1S4,4151,158,1,44113,26.55,0,63.16,1
M6S4B9,4152,158,7,44120,26.55,2,63.16,4
L3T1X3,4153,158,3,44123,25.70,1,66.84,2
M6S1S8,4154,158,4,44127,26.55,1,63.15,3
M6S4B8,4155,158,10,44137,26.55,3,63.15,6
M6S3Y6,4156,158,26,44163,26.55,7,63.15,16
M6S4C2,4157,158,34,44197,26.55,9,63.15,21
M6S1S9,4158,158,4,44201,26.55,1,63.15,3
M6S4V9,4159,158,5,44206,26.55,1,63.14,3
M4R2A8,4160,158,2,44208,26.12,1,65.00,1
M4R2H4,4161,158,1,44209,27.04,0,61.02,1
M6S1S5,4162,158,5,44214,26.55,1,63.14,3
M4R2A7,4163,158,4,44218,26.12,1,65.00,3
M6S3Y5,4164,158,7,44225,26.55,2,63.13,4
M5N2G8,4165,158,3,44228,26.12,1,65.00,2
L3T4R8,4166,158,3,44231,25.70,1,66.81,2
L3T4C4,4167,158,17,44248,27.53,5,58.89,10
M4R1N1,4168,158,17,44265,26.12,4,64.99,11
M4R1L2,4169,158,11,44276,26.12,3,64.99,7
M4R1N3,4170,158,16,44292,26.12,4,64.99,10
M4R1M4,4171,158,9,44301,26.12,2,64.99,6
M6S4H5,4172,158,6,44307,26.55,2,63.13,4
M4R1K2,4173,158,37,44344,26.12,10,64.99,24
M4R1L4,4174,158,30,44374,26.12,8,64.99,19
M4R1Y1,4175,158,3,44377,26.12,1,64.99,2
M4R1M2,4176,158,17,44394,26.12,4,64.99,11
M4R1M3,4177,158,25,44419,26.12,7,64.99,16
M4R1L5,4178,158,11,44430,26.12,3,64.99,7
M6S1S3,4179,158,3,44433,26.55,1,63.12,2
M4R1T3,4180,158,28,44461,27.04,8,60.99,17
M4R1T5,4181,158,8,44469,27.04,2,60.99,5
M4R1T4,4182,158,29,44498,27.04,8,60.99,18
M4R1S6,4183,158,23,44521,27.04,6,60.99,14
M5M1A9,4184,158,19,44540,27.04,5,60.99,12
M6S4V1,4185,158,1,44541,27.82,0,57.61,1
M5M1A7,4186,158,29,44570,27.04,8,60.99,18
M4R1T6,4187,158,15,44585,27.04,4,60.99,9
M4R1R9,4188,158,13,44598,27.04,4,60.99,8
M4R1X3,4189,158,1,44599,27.04,0,60.98,1
M4R1S2,4190,158,5,44604,27.04,1,60.98,3
M5M3L2,4191,158,10,44614,26.60,3,62.88,6
M4R1Y6,4192,158,1,44615,27.04,0,60.98,1
M5M1Y5,4193,158,25,44640,26.60,7,62.88,16
M5M2A7,4194,158,27,44667,26.60,7,62.88,17
L3T4L2,4195,158,4,44671,27.59,1,58.59,2
M5M2E7,4196,158,7,44678,27.40,2,59.40,4
M6S1X4,4197,158,1,44679,27.82,0,57.58,1
M5M3K7,4198,158,4,44683,26.60,1,62.87,3
M5M2B5,4199,158,11,44694,27.40,3,59.40,7
M6S1T1,4200,158,1,44695,26.55,0,63.08,1
M9A4N3,4201,158,10,44705,27.65,3,58.27,6
M4K1L2,4202,158,4,44709,26.15,1,64.69,3
M4K2X3,4203,158,25,44734,26.15,7,64.69,16
L3T1G4,4204,158,6,44740,24.57,1,71.52,4
M3H5Z7,4205,158,27,44767,26.81,7,61.82,17
M5P2N1,4206,158,2,44769,23.21,0,77.41,2
M2P1K6,4207,158,8,44777,25.61,2,67.01,5
M4V1Y6,4208,158,1,44778,23.21,0,77.39,1
M4V2R3,4209,158,8,44786,23.21,2,77.39,6
M2L2L7,4210,158,18,44804,25.67,5,66.73,12
M4V2R2,4211,158,7,44811,23.21,2,77.38,5
M4V2L9,4212,158,9,44820,23.21,2,77.38,7
M4V2S6,4213,158,4,44824,23.21,1,77.38,3
M4V2S8,4214,158,8,44832,23.21,2,77.38,6
M4V2V3,4215,158,10,44842,23.21,2,77.38,8
M4V2S7,4216,158,10,44852,23.21,2,77.37,8
M4V1Y7,4217,157,1,44853,23.21,0,77.33,1
M4V3A8,4218,157,1,44854,23.21,0,77.32,1
M4V2P9,4219,157,6,44860,23.23,1,77.23,5
M4V2V1,4220,157,1,44861,23.21,0,77.30,1
M5P2G5,4221,157,20,44881,25.25,5,68.47,14
M4P2S5,4222,157,4,44885,27.32,1,59.48,2
M4P2R8,4223,157,4,44889,27.32,1,59.47,2
M4P2P1,4224,157,6,44895,27.32,2,59.47,4
M3H3B3,4225,157,4,44899,27.35,1,59.34,2
M4P1W8,4226,157,6,44905,27.32,2,59.46,4
M4P2T7,4227,157,6,44911,27.32,2,59.46,4
M4P2T1,4228,157,6,44917,27.32,2,59.46,4
M2L1A4,4229,157,1,44918,24.28,0,72.63,1
M3H2B2,4230,157,18,44936,27.35,5,59.33,11
M3H2A2,4231,157,18,44954,27.35,5,59.33,11
M4P1X5,4232,157,8,44962,27.32,2,59.46,5
M4P1X3,4233,157,7,44969,27.32,2,59.46,4
M4P2P2,4234,157,6,44975,27.32,2,59.46,4
M3H2A1,4235,157,27,45002,27.35,7,59.33,16
M4P1T2,4236,157,11,45013,27.32,3,59.46,7
M3H3B2,4237,157,3,45016,27.35,1,59.33,2
M4P2P9,4238,157,6,45022,27.32,2,59.45,4
M4P2S4,4239,157,6,45028,27.32,2,59.45,4
M2L1N9,4240,157,5,45033,24.28,1,72.62,4
M3H2B1,4241,157,7,45040,27.35,2,59.32,4
M4P2T2,4242,157,6,45046,27.32,2,59.45,4
M3H2A3,4243,157,15,45061,27.35,4,59.32,9
M4P1W2,4244,157,16,45077,27.32,4,59.45,10
M4P1X1,4245,157,4,45081,27.32,1,59.45,2
M3B1H8,4246,157,7,45088,24.28,2,72.62,5
M2L1P1,4247,157,4,45092,24.28,1,72.62,3
M2L1P2,4248,157,5,45097,24.28,1,72.62,4
M3B3M7,4249,157,9,45106,24.28,2,72.62,7
M3B3N4,4250,157,2,45108,24.28,0,72.62,1
M2L1N6,4251,157,11,45119,24.28,3,72.62,8
M2L1N7,4252,157,5,45124,24.28,1,72.62,4
M2L1C9,4253,157,18,45142,24.28,4,72.62,13
M2L1N4,4254,157,6,45148,24.28,1,72.62,4
M2L1C8,4255,157,22,45170,24.28,5,72.62,16
M4P1W6,4256,157,4,45174,27.32,1,59.44,2
M2L1E1,4257,157,12,45186,24.28,3,72.61,9
M2L1A5,4258,157,4,45190,24.28,1,72.61,3
M2L1N3,4259,157,14,45204,24.28,3,72.61,10
M2L2Y6,4260,157,3,45207,24.28,1,72.61,2
M4P2R1,4261,157,4,45211,27.32,1,59.44,2
M3B2B4,4262,157,2,45213,24.28,0,72.61,1
M2L1N8,4263,157,9,45222,24.28,2,72.61,7
M2L2Y2,4264,157,3,45225,24.28,1,72.60,2
M3B2B3,4265,157,2,45227,24.28,0,72.60,1
M4P2T8,4266,157,3,45230,27.32,1,59.43,2
M6B1T7,4267,157,13,45243,26.00,3,65.14,8
M2L1N5,4268,157,1,45244,24.28,0,72.59,1
M8X2N5,4269,157,9,45253,27.11,2,60.32,5
M2L1B1,4270,157,2,45255,24.28,0,72.58,1
M8X1W3,4271,157,15,45270,27.11,4,60.32,9
M3H0A9,4272,157,4,45274,29.46,1,50.14,2
M8X2Z6,4273,157,32,45306,27.11,9,60.32,19
M8X1W2,4274,157,8,45314,27.11,2,60.32,5
M8X1V4,4275,157,8,45322,27.11,2,60.32,5
M8X2M8,4276,157,6,45328,27.11,2,60.31,4
M4V2T8,4277,157,15,45343,26.12,4,64.58,10
L3T4E1,4278,157,23,45366,27.58,6,58.21,13
M6S2E9,4279,157,3,45369,27.05,1,60.49,2
M3A3C3,4280,157,4,45373,26.76,1,61.74,2
M6S2H5,4281,157,29,45402,27.05,8,60.47,18
M6S2E6,4282,157,8,45410,27.05,2,60.47,5
M3B2K1,4283,157,4,45414,25.78,1,65.97,3
M9B6H9,4284,157,2,45416,27.48,1,58.60,1
M6S4G6,4285,157,20,45436,27.05,5,60.46,12
M6S2G1,4286,157,12,45448,27.05,3,60.46,7
M9A5A3,4287,157,8,45456,29.46,2,50.01,4
M4V1V4,4288,157,1,45457,26.12,0,64.47,1
M3B2H3,4289,157,5,45462,25.77,1,65.99,3
M9B4R4,4290,157,3,45465,27.48,1,58.58,2
M3B1H4,4291,157,6,45471,25.77,2,65.98,4
M9B5C7,4292,157,11,45482,27.48,3,58.57,6
M9B5C4,4293,157,16,45498,27.48,4,58.57,9
M9B4R2,4294,157,16,45514,27.48,4,58.57,9
M3B1A5,4295,157,8,45522,25.77,2,65.98,5
M9B5C1,4296,157,14,45536,27.48,4,58.57,8
M9B5C2,4297,157,14,45550,27.48,4,58.57,8
M3B2G6,4298,157,10,45560,25.77,3,65.98,7
M3B1G4,4299,157,6,45566,25.77,2,65.98,4
M3B2K3,4300,157,5,45571,25.77,1,65.98,3
M9B5B4,4301,157,10,45581,27.48,3,58.57,6
M9B2E2,4302,157,12,45593,27.48,3,58.57,7
M9B2B7,4303,157,5,45598,27.48,1,58.57,3
M3B2G5,4304,157,30,45628,25.77,8,65.97,20
M3B2J8,4305,157,9,45637,25.77,2,65.97,6
M9B5E1,4306,157,12,45649,27.48,3,58.56,7
M3B2H1,4307,157,40,45689,25.77,10,65.97,26
M3B1E7,4308,157,19,45708,25.77,5,65.97,13
M3B2J9,4309,157,4,45712,25.77,1,65.97,3
M3B1G5,4310,157,4,45716,25.77,1,65.97,3
M3B2J7,4311,157,22,45738,25.77,6,65.97,15
M6S4G5,4312,157,16,45754,27.04,4,60.47,10
M6S4L2,4313,157,17,45771,27.04,5,60.47,10
M3B2H2,4314,157,8,45779,25.77,2,65.97,5
M2P1G5,4315,157,3,45782,25.35,1,67.78,2
M6S4C6,4316,157,17,45799,27.04,5,60.46,10
M3B1C6,4317,157,3,45802,25.77,1,65.96,2
L3T1K3,4318,157,11,45813,24.18,3,72.85,8
M3B1C5,4319,157,3,45816,25.77,1,65.96,2
M3B2K7,4320,157,1,45817,25.78,0,65.90,1
M3B2K5,4321,157,2,45819,25.77,1,65.94,1
M9B2B9,4322,157,1,45820,27.48,0,58.52,1
M2L2Y8,4323,157,2,45822,22.37,0,80.65,2
L4J8A8,4324,157,37,45859,27.66,10,57.70,21
L4J8A9,4325,157,38,45897,27.66,11,57.70,22
M9B2G8,4326,157,1,45898,27.48,0,58.47,1
L3T2W6,4327,157,17,45915,24.10,4,73.10,12
M9A3P4,4328,157,2,45917,27.93,1,56.51,1
M8W4S1,4329,157,5,45922,30.51,2,45.32,2
M3A3C1,4330,157,26,45948,26.71,7,61.78,16
M3A2Z3,4331,157,26,45974,26.71,7,61.78,16
M2K1T5,4332,157,1,45975,25.97,0,64.99,1
M3A2Z4,4333,157,27,46002,26.71,7,61.78,17
M8W4S7,4334,157,14,46016,30.51,4,45.31,6
M3H2A9,4335,157,14,46030,25.92,4,65.19,9
M6C0A3,4336,157,1,46031,29.41,0,50.05,1
M6C3H2,4337,157,4,46035,25.17,1,68.38,3
M4G2W4,4338,157,9,46044,26.87,2,61.01,5
M4G2S3,4339,157,13,46057,26.87,3,61.01,8
L4L7T2,4340,157,15,46072,26.24,4,63.74,10
M4G2S1,4341,157,12,46084,26.86,3,61.02,7
M4G3R4,4342,157,19,46103,26.86,5,61.01,12
M4G3X9,4343,157,25,46128,26.86,7,61.01,15
M4G1K9,4344,157,22,46150,26.86,6,61.01,13
L3T2R7,4345,157,3,46153,25.79,1,65.63,2
M9P2W9,4346,157,1,46154,26.78,0,61.31,1
M3A3H5,4347,157,2,46156,25.61,1,66.37,1
M2N2V3,4348,157,15,46171,26.62,4,61.99,9
M9P3B8,4349,157,2,46173,26.78,1,61.30,1
M3A3J8,4350,157,27,46200,25.61,7,66.35,18
M3A3J2,4351,157,8,46208,25.61,2,66.35,5
L4L1Y8,4352,157,4,46212,28.67,1,53.10,2
M3A3J4,4353,157,9,46221,25.61,2,66.35,6
M9P2W6,4354,157,3,46224,26.78,1,61.28,2
M3A3J1,4355,157,18,46242,25.61,5,66.35,12
M3A3H8,4356,157,9,46251,25.61,2,66.35,6
M3A3H7,4357,157,10,46261,25.61,3,66.35,7
M9P1V4,4358,157,6,46267,26.78,2,61.28,4
L4L8X4,4359,157,26,46293,28.67,7,53.08,14
M9P1S9,4360,157,8,46301,26.78,2,61.27,5
M9P1S1,4361,157,8,46309,26.78,2,61.27,5
M3A3H9,4362,157,3,46312,25.61,1,66.34,2
L4L8X8,4363,157,34,46346,28.67,10,53.08,18
L4L9C4,4364,157,46,46392,28.67,13,53.08,24
L4L1S2,4365,157,23,46415,28.67,7,53.08,12
M9P1Z6,4366,157,10,46425,26.78,3,61.27,6
L4L8X5,4367,157,39,46464,28.67,11,53.08,21
M9P1X9,4368,157,14,46478,26.78,4,61.27,9
L4L8X7,4369,157,46,46524,28.67,13,53.08,24
L4L1S3,4370,157,22,46546,28.67,6,53.08,12
L4L8X6,4371,157,47,46593,28.67,13,53.08,25
M9P1S8,4372,157,11,46604,26.78,3,61.27,7
M9P1V2,4373,157,18,46622,26.78,5,61.27,11
M3B0A7,4374,157,2,46624,29.25,1,50.57,1
M9P1X5,4375,157,4,46628,26.78,1,61.26,2
M9P1T6,4376,157,11,46639,26.78,3,61.26,7
M9P1X4,4377,157,30,46669,26.78,8,61.26,18
M9P2W8,4378,157,3,46672,26.78,1,61.26,2
M9P2X4,4379,157,9,46681,26.78,2,61.26,6
M9P1X8,4380,157,12,46693,26.78,3,61.26,7
M9P1S2,4381,157,13,46706,26.78,3,61.26,8
L4L1Y7,4382,157,9,46715,28.67,3,53.07,5
M9P1R9,4383,157,6,46721,26.78,2,61.26,4
M9P1Y6,4384,157,10,46731,26.78,3,61.26,6
M9P1Y7,4385,157,10,46741,26.78,3,61.26,6
M2N2K6,4386,157,1,46742,27.41,0,58.53,1
M9P2Z2,4387,157,8,46750,26.78,2,61.25,5
M4S2T2,4388,157,3,46753,26.33,1,63.20,2
M9P3B9,4389,157,4,46757,26.78,1,61.25,2
M5M1L4,4390,157,17,46774,26.69,5,61.63,10
M2N1V7,4391,157,14,46788,27.41,4,58.51,8
M2N1S1,4392,157,13,46801,27.41,4,58.51,8
M9P3S6,4393,157,5,46806,26.78,1,61.24,3
M4S2R9,4394,157,6,46812,26.33,2,63.18,4
M2N1V9,4395,157,13,46825,27.41,4,58.50,8
M4S2S1,4396,157,7,46832,26.33,2,63.18,4
M4S1M6,4397,157,14,46846,26.33,4,63.17,9
M4S1P6,4398,157,9,46855,26.33,2,63.17,6
M4S1S4,4399,157,19,46874,26.33,5,63.17,12
M4S2S3,4400,157,2,46876,26.33,1,63.17,1
M4S1S2,4401,157,65,46941,26.33,17,63.17,41
M4S2T3,4402,157,6,46947,26.33,2,63.16,4
M4S1P5,4403,157,11,46958,26.33,3,63.16,7
L3T2V5,4404,157,15,46973,23.80,4,74.12,11
M4Y1A1,4405,157,1,46974,25.77,0,65.56,1
M9P3P9,4406,157,1,46975,26.77,0,61.22,1
L3T2V7,4407,157,2,46977,23.79,0,74.13,1
M5P2M9,4408,157,10,46987,25.68,3,65.94,7
M9A3G5,4409,157,2,46989,27.14,1,59.61,1
L3T1K4,4410,157,10,46999,23.79,2,74.12,7
M3A3H6,4411,157,9,47008,25.58,2,66.36,6
M3A3K1,4412,157,13,47021,25.58,3,66.36,9
M3A3K2,4413,157,11,47032,25.58,3,66.35,7
M3A3J6,4414,157,8,47040,25.58,2,66.35,5
M3A3J5,4415,157,9,47049,25.58,2,66.35,6
M3A3H4,4416,157,14,47063,25.58,4,66.35,9
M3A3M6,4417,157,11,47074,25.58,3,66.35,7
M4G3R8,4418,157,5,47079,27.90,1,56.29,3
M4G1M6,4419,157,20,47099,27.90,6,56.29,11
M4G3R7,4420,157,22,47121,27.90,6,56.29,12
M4G1H9,4421,157,24,47145,27.90,7,56.29,14
M4G1H8,4422,157,15,47160,27.90,4,56.29,8
M5P2N2,4423,157,2,47162,26.10,1,64.07,1
M5P2M5,4424,157,4,47166,26.10,1,64.07,3
M5P2L9,4425,157,16,47182,26.10,4,64.07,10
M5P1B4,4426,157,6,47188,26.10,2,64.07,4
M5P2M1,4427,157,12,47200,26.10,3,64.07,8
M5R2N3,4428,157,3,47203,26.04,1,64.33,2
M5P2K2,4429,157,4,47207,26.10,1,64.07,3
M5P1L8,4430,157,9,47216,26.10,2,64.07,6
M5P2N3,4431,157,50,47266,26.10,13,64.07,32
M5P1M2,4432,157,10,47276,26.10,3,64.06,6
M5P1K2,4433,157,5,47281,26.10,1,64.06,3
M5P1M1,4434,157,10,47291,26.10,3,64.06,6
M5P1J9,4435,157,7,47298,26.10,2,64.06,4
M5P1B5,4436,157,2,47300,26.10,1,64.05,1
M4G3M7,4437,157,2,47302,27.89,1,56.30,1
M4B1P7,4438,157,5,47307,28.92,1,51.78,3
L4J7V6,4439,157,45,47352,29.22,13,50.48,23
L4J7V7,4440,157,39,47391,29.22,11,50.48,20
M4V2L7,4441,157,6,47397,23.42,1,75.60,5
M4B2Z6,4442,157,9,47406,28.92,3,51.77,5
M4B2Y3,4443,157,7,47413,28.92,2,51.77,4
M4K1V9,4444,157,32,47445,24.68,8,70.14,22
M4B1P8,4445,157,6,47451,28.92,2,51.77,3
M4B2Z1,4446,157,4,47455,28.92,1,51.77,2
M4B2Z2,4447,157,10,47465,28.92,3,51.76,5
M4B1R2,4448,157,4,47469,28.92,1,51.76,2
M4B1P9,4449,157,13,47482,28.92,4,51.76,7
M4B2Z3,4450,157,10,47492,28.92,3,51.76,5
M4B2Y5,4451,157,5,47497,28.92,1,51.76,3
M4B1R9,4452,157,13,47510,28.92,4,51.76,7
M4B2Y9,4453,157,4,47514,28.92,1,51.76,2
M4B2Z7,4454,157,9,47523,28.92,3,51.76,5
M4B2Z5,4455,157,11,47534,28.92,3,51.76,6
M4B1S1,4456,157,5,47539,28.92,1,51.75,3
M4B1R6,4457,157,11,47550,28.92,3,51.75,6
M4B1R7,4458,157,5,47555,28.92,1,51.75,3
M3A2K8,4459,157,16,47571,27.37,4,58.45,9
M3A1M4,4460,157,14,47585,27.37,4,58.45,8
M3A1S4,4461,157,18,47603,27.37,5,58.45,11
M4V1H6,4462,157,42,47645,23.35,10,75.86,32
M3A3B8,4463,157,7,47652,26.58,2,61.86,4
M3A3C5,4464,157,11,47663,26.68,3,61.38,7
M5M3L1,4465,157,4,47667,26.33,1,62.89,3
M5M2A8,4466,157,32,47699,26.33,8,62.88,20
M5M2C9,4467,157,13,47712,26.33,3,62.88,8
M5M3G7,4468,157,9,47721,26.33,2,62.88,6
M5M2C8,4469,157,16,47737,26.33,4,62.88,10
M3B2Z4,4470,157,17,47754,26.83,5,60.67,10
M3B2Z7,4471,157,7,47761,26.83,2,60.66,4
M9B2H9,4472,157,1,47762,26.01,0,64.18,1
M3H2V4,4473,157,3,47765,26.55,1,61.82,2
M3H2M2,4474,157,23,47788,26.55,6,61.82,14
M3H5Z8,4475,157,44,47832,26.55,12,61.81,27
M3A3C4,4476,157,26,47858,26.64,7,61.42,16
L3T1C7,4477,157,6,47864,23.40,1,75.44,5
M9B2J5,4478,157,2,47866,26.01,1,64.12,1
M9B4X7,4479,157,3,47869,26.01,1,64.12,2
L3T2V1,4480,157,2,47871,23.40,0,75.43,2
L4J7X4,4481,157,38,47909,24.44,9,70.92,27
L3T2T9,4482,157,21,47930,23.40,5,75.43,16
L3T2V6,4483,157,10,47940,23.40,2,75.43,8
L4J7X5,4484,157,32,47972,24.44,8,70.92,23
L3T1A8,4485,157,15,47987,23.40,4,75.42,11
L3T2T8,4486,157,7,47994,23.40,2,75.42,5
L3T1J8,4487,157,3,47997,23.40,1,75.42,2
L3T7L5,4488,157,1,47998,23.40,0,75.42,1
L3T7M7,4489,157,5,48003,23.40,1,75.41,4
L3T1J9,4490,157,2,48005,23.40,0,75.41,2
M9B3N1,4491,157,4,48009,26.01,1,64.10,3
M9B4X9,4492,157,7,48016,26.01,2,64.10,4
M5M3T2,4493,157,4,48020,26.68,1,61.20,2
M9B4X2,4494,157,6,48026,26.01,2,64.10,4
M5M3T3,4495,157,5,48031,26.68,1,61.19,3
M5M1E4,4496,157,12,48043,26.68,3,61.19,7
L4J7B5,4497,157,19,48062,25.07,5,68.17,13
M4G2C6,4498,157,11,48073,27.55,3,57.42,6
M4G3G9,4499,157,15,48088,27.55,4,57.42,9
M4G3P1,4500,157,8,48096,27.55,2,57.42,5
L3T5T8,4501,157,3,48099,23.39,1,75.44,2
M9B4W9,4502,157,4,48103,26.01,1,64.09,3
M9B4X3,4503,157,5,48108,26.01,1,64.09,3
M9B4Y7,4504,157,6,48114,26.01,2,64.09,4
M5M1A8,4505,157,39,48153,26.68,10,61.19,24
M4G2C9,4506,157,9,48162,27.55,2,57.42,5
M9B4X5,4507,157,12,48174,26.01,3,64.09,8
M4G2A2,4508,157,8,48182,27.55,2,57.42,5
M9B4X4,4509,157,15,48197,26.01,4,64.09,10
M4G2B2,4510,157,10,48207,27.55,3,57.42,6
M5M1G7,4511,157,42,48249,26.68,11,61.19,26
M5M1E1,4512,157,36,48285,26.68,10,61.19,22
L3T1C6,4513,157,6,48291,23.39,1,75.44,5
M4G3H2,4514,157,9,48300,27.55,2,57.42,5
M4G2A3,4515,157,7,48307,27.55,2,57.41,4
M9B2J7,4516,157,2,48309,26.01,1,64.08,1
M9B4X1,4517,157,4,48313,26.01,1,64.08,3
L3T2S9,4518,157,4,48317,23.39,1,75.43,3
M9B4X6,4519,156,4,48321,26.01,1,64.08,3
M9B3M9,4520,156,5,48326,26.01,1,64.07,3
L3T2T1,4521,156,9,48335,23.39,2,75.42,7
L3T5T9,4522,156,4,48339,23.39,1,75.42,3
L3T1G5,4523,156,5,48344,23.39,1,75.42,4
M4G3K6,4524,156,3,48347,27.54,1,57.43,2
M4G2C5,4525,156,7,48354,27.54,2,57.43,4
M4G2E2,4526,156,9,48363,27.54,2,57.43,5
M4G3K5,4527,156,2,48365,27.54,1,57.42,1
M4G3N8,4528,156,15,48380,27.54,4,57.42,9
M4G2C7,4529,156,11,48391,27.54,3,57.42,6
M4G3H1,4530,156,5,48396,27.54,1,57.42,3
M4G2K3,4531,156,7,48403,27.54,2,57.42,4
M4G2B1,4532,156,19,48422,27.54,5,57.42,11
M4G2E3,4533,156,6,48428,27.54,2,57.42,3
L4J7V8,4534,156,38,48466,29.23,11,50.09,19
M6P1T8,4535,156,8,48474,25.69,2,65.39,5
M9B2H7,4536,156,1,48475,26.01,0,64.01,1
M8Y4A2,4537,156,1,48476,25.70,0,65.33,1
M8Y1S8,4538,156,2,48478,25.73,1,65.20,1
M8Y3K1,4539,156,8,48486,25.73,2,65.19,5
M4P2R9,4540,156,2,48488,27.05,1,59.47,1
M8Y3H4,4541,156,8,48496,25.73,2,65.18,5
M8X2S8,4542,156,8,48504,27.96,2,55.51,4
M1W1J6,4543,156,10,48514,26.75,3,60.75,6
M8X1T8,4544,156,7,48521,27.96,2,55.50,4
M8X1W8,4545,156,10,48531,27.96,3,55.50,6
M8X2P8,4546,156,12,48543,27.96,3,55.50,7
M8X2S1,4547,156,9,48552,27.96,3,55.50,5
M8X2P2,4548,156,16,48568,27.96,4,55.50,9
M8X1W1,4549,156,8,48576,27.96,2,55.50,4
M8X1V9,4550,156,12,48588,27.96,3,55.50,7
M8X2S2,4551,156,5,48593,27.96,1,55.49,3
M8X1W6,4552,156,2,48595,27.96,1,55.49,1
M8X2N4,4553,156,4,48599,27.96,1,55.49,2
M4R1G5,4554,156,42,48641,25.94,11,64.23,27
M1W1M2,4555,156,1,48642,26.75,0,60.70,1
M8Y3H2,4556,156,8,48650,25.71,2,65.20,5
M8Y3J9,4557,156,2,48652,25.70,1,65.24,1
M8Y1X4,4558,156,7,48659,25.71,2,65.20,5
M8Y1Y2,4559,156,8,48667,25.71,2,65.19,5
M8Y3V5,4560,156,11,48678,25.71,3,65.19,7
M4K1M6,4561,156,39,48717,25.82,10,64.69,25
M8Y3H1,4562,156,8,48725,25.70,2,65.20,5
M8Y3G3,4563,156,8,48733,25.70,2,65.20,5
M8Y1Y1,4564,156,8,48741,25.70,2,65.20,5
M8Y1Y7,4565,156,7,48748,25.70,2,65.20,5
M8Y1S4,4566,156,20,48768,25.70,5,65.20,13
M8Y3H3,4567,156,7,48775,25.70,2,65.19,5
M8Y1S5,4568,156,16,48791,25.70,4,65.19,10
M8Y4B8,4569,156,7,48798,25.70,2,65.19,5
M8Y1Y5,4570,156,8,48806,25.70,2,65.19,5
M8Y1X6,4571,156,12,48818,25.70,3,65.19,8
M8Y1S6,4572,156,5,48823,25.70,1,65.19,3
M8Y1X5,4573,156,4,48827,25.70,1,65.19,3
M8Y3G8,4574,156,6,48833,25.70,2,65.19,4
M8W4R4,4575,156,2,48835,30.28,1,45.34,1
M8Y3H5,4576,156,6,48841,25.70,2,65.18,4
M8Y4A1,4577,156,3,48844,25.70,1,65.18,2
M8Y3Z9,4578,156,3,48847,25.70,1,65.18,2
M8Y1S7,4579,156,2,48849,25.70,1,65.17,1
M8Y3G9,4580,156,5,48854,25.70,1,65.17,3
M8W4R3,4581,156,3,48857,30.28,1,45.32,1
M8Y1X2,4582,156,2,48859,25.70,1,65.16,1
M8W4N4,4583,156,10,48869,30.28,3,45.32,5
M8W4T1,4584,156,10,48879,30.28,3,45.31,5
M8W2J6,4585,156,12,48891,30.28,4,45.31,5
M8Z3V9,4586,156,4,48895,27.16,1,58.83,2
M8W2J5,4587,156,1,48896,30.28,0,45.31,0
M8W4S9,4588,156,10,48906,30.28,3,45.31,5
M8W4R5,4589,156,13,48919,30.28,4,45.31,6
M8Z3B2,4590,156,3,48922,27.16,1,58.83,2
M8W2H9,4591,156,13,48935,30.28,4,45.31,6
M3B2K6,4592,156,3,48938,25.51,1,65.97,2
M2P2A5,4593,156,2,48940,25.09,1,67.79,1
M8W4R2,4594,156,5,48945,30.28,2,45.31,2
M2P1Z8,4595,156,6,48951,25.09,2,67.79,4
M2P1H8,4596,156,3,48954,25.09,1,67.79,2
M8Y1X3,4597,156,1,48955,25.70,0,65.14,1
M2P1H9,4598,156,4,48959,25.09,1,67.79,3
M3B1A4,4599,156,8,48967,25.51,2,65.97,5
M8Y4A3,4600,156,1,48968,25.70,0,65.14,1
M8Z4K9,4601,156,1,48969,27.16,0,58.82,1
M2P1J7,4602,156,8,48977,25.09,2,67.78,5
M2P1W4,4603,156,4,48981,25.09,1,67.78,3
M8W4R6,4604,156,6,48987,30.28,2,45.30,3
M5M2S1,4605,156,18,49005,29.03,5,50.71,9
M8W4N6,4606,156,2,49007,30.28,1,45.30,1
M2P1V4,4607,156,17,49024,25.09,4,67.78,12
M2P1W1,4608,156,19,49043,25.09,5,67.78,13
M2P1W2,4609,156,14,49057,25.09,4,67.78,9
M2P1X6,4610,156,14,49071,25.09,4,67.78,9
M2P1J1,4611,156,10,49081,25.09,3,67.78,7
M2P1J6,4612,156,11,49092,25.09,3,67.78,7
M2P1Z7,4613,156,18,49110,25.09,5,67.78,12
M5M2V6,4614,156,23,49133,29.03,7,50.71,12
M2P1J2,4615,156,13,49146,25.09,3,67.77,9
M8Z4N5,4616,156,7,49153,27.16,2,58.81,4
M8W2J1,4617,156,5,49158,30.28,2,45.29,2
M8Z4N6,4618,156,4,49162,27.16,1,58.80,2
M8Z4K5,4619,156,7,49169,27.16,2,58.80,4
M2P1W9,4620,156,1,49170,25.09,0,67.77,1
M2P1Y2,4621,156,4,49174,25.09,1,67.77,3
M8Z2X9,4622,156,4,49178,27.16,1,58.80,2
M8Z2Y1,4623,156,15,49193,27.16,4,58.79,9
M8Z2W6,4624,156,4,49197,27.16,1,58.79,2
M8W2H8,4625,156,1,49198,30.28,0,45.28,0
M8Z4K6,4626,156,17,49215,27.16,5,58.79,10
M8Z4J2,4627,156,19,49234,27.16,5,58.79,11
M8Z2W2,4628,156,15,49249,27.16,4,58.79,9
M8Z2V9,4629,156,10,49259,27.16,3,58.79,6
M8Z3B7,4630,156,4,49263,27.16,1,58.78,2
M8Z2V7,4631,156,10,49273,27.16,3,58.78,6
M9B5B5,4632,156,10,49283,27.21,3,58.56,6
M8Z3B4,4633,156,3,49286,27.16,1,58.77,2
M6P2W5,4634,156,8,49294,25.98,2,63.88,5
M4W3T3,4635,156,111,49405,27.66,31,56.53,63
M8Z4K7,4636,156,1,49406,27.16,0,58.70,1
L4J8B5,4637,156,38,49444,27.39,10,57.70,22
M5R1Z3,4638,156,8,49452,25.52,2,65.78,5
M9R4C8,4639,156,26,49478,29.03,8,50.56,13
M5R1Z9,4640,156,4,49482,25.52,1,65.77,3
L3T3B3,4641,156,15,49497,25.85,4,64.34,10
M9A3P5,4642,156,1,49498,27.65,0,56.50,1
M4R1G1,4643,156,38,49536,24.98,9,68.07,26
M9A1A7,4644,156,5,49541,27.65,1,56.50,3
M9A2V9,4645,156,3,49544,27.65,1,56.49,2
M9A3N6,4646,156,3,49547,27.65,1,56.49,2
M9A2V1,4647,156,15,49562,27.65,4,56.49,8
M9A2V8,4648,156,30,49592,27.65,8,56.49,17
M9A3P2,4649,156,28,49620,27.65,8,56.49,16
M9A2V7,4650,156,7,49627,27.65,2,56.49,4
M9A3P3,4651,156,7,49634,27.65,2,56.49,4
M9A2V2,4652,156,22,49656,27.65,6,56.48,12
M9A3N5,4653,156,9,49665,27.65,2,56.48,5
M9A1A4,4654,156,29,49694,27.65,8,56.48,16
M9A2T9,4655,156,11,49705,27.65,3,56.48,6
M9A3N4,4656,156,9,49714,27.65,2,56.48,5
M9A2V3,4657,156,2,49716,27.65,1,56.48,1
M4G2W2,4658,156,10,49726,26.60,3,61.01,6
M4G3R5,4659,156,23,49749,26.60,6,61.01,14
M5N1R7,4660,156,23,49772,23.63,5,73.84,17
M5N1S8,4661,156,27,49799,23.63,6,73.84,20
M5N1P5,4662,156,24,49823,23.63,6,73.83,18
M5N1R6,4663,156,24,49847,23.63,6,73.83,18
M5N1T8,4664,156,27,49874,23.63,6,73.83,20
M5N1S7,4665,156,30,49904,23.63,7,73.83,22
M4J2W1,4666,156,6,49910,26.18,2,62.78,4
L4J7T5,4667,156,44,49954,25.77,11,64.55,28
M4J2V3,4668,156,8,49962,26.18,2,62.77,5
M4J3Z7,4669,156,10,49972,26.18,3,62.77,6
M4J3Z6,4670,156,3,49975,26.18,1,62.77,2
M4J3X4,4671,156,11,49986,26.18,3,62.77,7
M4J2X3,4672,156,12,49998,26.18,3,62.77,8
M4J2V7,4673,156,9,50007,26.18,2,62.77,6
M4J3W2,4674,156,3,50010,26.18,1,62.76,2
M4J2X1,4675,156,20,50030,26.18,5,62.76,13
M4J4H5,4676,156,11,50041,26.18,3,62.76,7
M4J4G5,4677,156,9,50050,26.18,2,62.75,6
M5R3E8,4678,156,31,50081,25.55,8,65.48,20
M4J4H6,4679,156,12,50093,26.18,3,62.75,8
M5N2R3,4680,156,2,50095,23.63,0,73.80,1
M4J2X6,4681,156,5,50100,26.18,1,62.74,3
M4T2C7,4682,156,8,50108,22.53,2,78.54,6
L4L8E8,4683,156,26,50134,29.35,8,48.96,13
M4W1S7,4684,156,5,50139,25.59,1,65.18,3
M4W1S1,4685,156,4,50143,25.59,1,65.17,3
M4W2X5,4686,156,19,50162,25.59,5,65.17,12
M4W2Y1,4687,156,5,50167,25.59,1,65.16,3
M4W2X9,4688,156,7,50174,25.59,2,65.16,5
M4W1R9,4689,156,6,50180,25.59,2,65.16,4
M4W2V6,4690,156,20,50200,25.59,5,65.16,13
M4W1V3,4691,156,7,50207,25.59,2,65.16,5
M4W2V7,4692,156,2,50209,25.59,1,65.16,1
M4W1R8,4693,156,9,50218,25.59,2,65.16,6
M4W1S8,4694,156,4,50222,25.59,1,65.15,3
L4J7C9,4695,156,15,50237,25.14,4,67.10,10
M9R2T7,4696,156,2,50239,28.91,1,50.76,1
M9R2W8,4697,156,2,50241,28.91,1,50.75,1
L3T4E3,4698,156,14,50255,27.23,4,58.03,8
L4J1J4,4699,156,14,50269,26.15,4,62.70,9
M5P1H3,4700,156,8,50277,27.74,2,55.79,4
M2J4S2,4701,156,10,50287,25.06,3,67.39,7
M2J1X9,4702,156,16,50303,25.06,4,67.39,11
M5M2P6,4703,156,21,50324,28.98,6,50.41,11
M4G1L6,4704,156,7,50331,27.62,2,56.30,4
M2J1X5,4705,156,7,50338,25.06,2,67.38,5
M2J1X8,4706,156,7,50345,25.06,2,67.38,5
M9R2X1,4707,156,9,50354,28.91,3,50.69,5
M9R2T8,4708,156,26,50380,28.91,8,50.69,13
M9R1B9,4709,156,17,50397,28.91,5,50.69,9
L3T3B1,4710,156,14,50411,25.76,4,64.34,9
M9R1B3,4711,156,24,50435,28.91,7,50.69,12
M9R2T5,4712,156,9,50444,28.91,3,50.69,5
M9B3Y7,4713,156,3,50447,28.42,1,52.81,2
M9R2X8,4714,156,22,50469,28.91,6,50.69,11
M9R2X5,4715,156,12,50481,28.91,3,50.69,6
M9R2T9,4716,156,13,50494,28.91,4,50.69,7
M2J2L8,4717,156,2,50496,25.39,1,65.93,1
L3T3B4,4718,156,9,50505,25.76,2,64.33,6
M9R1B8,4719,156,3,50508,28.91,1,50.67,2
M9R1C1,4720,156,3,50511,28.91,1,50.67,2
M9R1C2,4721,156,2,50513,28.91,1,50.66,1
M2J2S5,4722,156,1,50514,25.39,0,65.91,1
M2J2N1,4723,156,2,50516,25.39,1,65.90,1
M2J2L9,4724,156,7,50523,25.39,2,65.90,5
M2J2N2,4725,156,6,50529,25.39,2,65.90,4
M2J2K3,4726,156,3,50532,25.39,1,65.89,2
M2J2T2,4727,156,3,50535,25.39,1,65.89,2
M2J2J3,4728,156,10,50545,25.39,3,65.89,7
M2J2J1,4729,156,8,50553,25.39,2,65.89,5
M2J2N3,4730,156,12,50565,25.39,3,65.89,8
M2J2M7,4731,156,19,50584,25.39,5,65.89,13
M2J2J2,4732,156,14,50598,25.39,4,65.89,9
M2J2M6,4733,156,12,50610,25.39,3,65.89,8
M2J2J8,4734,156,31,50641,25.39,8,65.88,20
M2J2J4,4735,156,5,50646,25.39,1,65.88,3
M2J2K5,4736,156,8,50654,25.39,2,65.88,5
M2J2M8,4737,156,8,50662,25.39,2,65.88,5
M2J1K7,4738,156,3,50665,25.39,1,65.88,2
M2J1K6,4739,156,3,50668,25.39,1,65.88,2
M2J2S6,4740,156,10,50678,25.39,3,65.87,7
L4L7V8,4741,156,16,50694,26.38,4,61.58,10
L4L7S4,4742,156,10,50704,26.46,3,61.21,6
M4K1L7,4743,156,2,50706,25.72,1,64.41,1
M4K3C9,4744,156,11,50717,25.72,3,64.41,7
M4X1S4,4745,156,7,50724,24.47,2,69.82,5
M4W2W6,4746,156,11,50735,19.41,2,91.74,10
M4K1L3,4747,156,37,50772,25.72,10,64.41,24
M4X1S5,4748,156,9,50781,24.47,2,69.82,6
M4X1A4,4749,156,16,50797,24.47,4,69.82,11
M4X1R5,4750,156,15,50812,24.47,4,69.81,10
M4X1S6,4751,156,10,50822,24.47,2,69.81,7
M4X1A3,4752,156,7,50829,24.47,2,69.81,5
M4W1J3,4753,156,2,50831,24.37,0,70.25,1
M5A2L5,4754,156,15,50846,24.47,4,69.81,10
M5A2M1,4755,156,6,50852,24.47,1,69.81,4
M3A1S5,4756,156,2,50854,27.09,1,58.46,1
M4X1W8,4757,156,9,50863,24.47,2,69.81,6
M4X1V1,4758,156,8,50871,24.47,2,69.81,6
M4X1S8,4759,156,7,50878,24.47,2,69.81,5
M4X1T7,4760,156,4,50882,24.47,1,69.81,3
M4X1T8,4761,156,7,50889,24.47,2,69.81,5
M5A2L9,4762,156,6,50895,24.47,1,69.80,4
M3A2L2,4763,156,12,50907,27.09,3,58.45,7
M3A2L3,4764,156,10,50917,27.09,3,58.45,6
M3A1S7,4765,156,11,50928,27.09,3,58.45,6
M3A2L4,4766,156,17,50945,27.09,5,58.45,10
M9P1X3,4767,156,22,50967,26.44,6,61.26,13
M3A2K2,4768,156,9,50976,27.09,2,58.45,5
M9P2S5,4769,156,6,50982,26.44,2,61.26,4
M9P1Y3,4770,156,25,51007,26.44,7,61.26,15
M3A1S2,4771,156,16,51023,27.09,4,58.45,9
M3A1T1,4772,156,11,51034,27.09,3,58.45,6
M4X1X5,4773,156,5,51039,24.47,1,69.80,3
M3A1S3,4774,156,23,51062,27.09,6,58.45,13
M3A1S8,4775,156,5,51067,27.09,1,58.44,3
M6B4L5,4776,156,1,51068,24.89,0,67.97,1
M5A2L7,4777,156,2,51070,24.47,0,69.78,1
M4M0B1,4778,156,4,51074,26.68,1,60.21,2
L3T5J5,4779,156,5,51079,26.08,1,62.80,3
M4K1M2,4780,156,34,51113,25.71,9,64.41,22
M4K3E1,4781,156,8,51121,25.71,2,64.41,5
M4K3E2,4782,156,29,51150,25.71,7,64.40,19
M4K1M1,4783,156,29,51179,25.71,7,64.40,19
M4K2Z3,4784,156,15,51194,25.71,4,64.40,10
M2J2M9,4785,156,1,51195,25.39,0,65.79,1
M4X1V6,4786,156,9,51204,24.36,2,70.25,6
L3T5S2,4787,156,2,51206,26.08,1,62.79,1
M4X1V2,4788,156,9,51215,24.36,2,70.24,6
M4X1T6,4789,156,10,51225,24.36,2,70.24,7
M4X1X4,4790,156,5,51230,24.36,1,70.23,4
M4X1V9,4791,156,7,51237,24.36,2,70.23,5
M4S2J2,4792,156,3,51240,26.18,1,62.32,2
M4S2J3,4793,156,5,51245,26.18,1,62.32,3
M4S1R3,4794,156,10,51255,26.18,3,62.31,6
M4S2H9,4795,156,8,51263,26.18,2,62.31,5
M4S2H5,4796,156,13,51276,26.18,3,62.31,8
M4S2G9,4797,156,19,51295,26.18,5,62.31,12
M4S2H6,4798,156,14,51309,26.18,4,62.31,9
M4S1R1,4799,156,9,51318,26.18,2,62.30,6
M6K3N4,4800,156,34,51352,22.52,8,78.14,27
M4S1V1,4801,156,65,51417,25.97,17,63.17,41
M5M1X4,4802,156,5,51422,28.40,1,52.64,3
M4G3H9,4803,155,9,51431,28.89,3,50.45,5
M4G3H8,4804,155,9,51440,28.89,3,50.45,5
M4G1S1,4805,155,11,51451,28.89,3,50.44,6
M4G3G3,4806,155,17,51468,28.89,5,50.44,9
M5M1E2,4807,155,38,51506,26.41,10,61.19,23
M4G3G2,4808,155,18,51524,28.89,5,50.44,9
M9R0A3,4809,155,82,51606,28.83,24,50.70,42
M4G1M1,4810,155,14,51620,28.89,4,50.44,7
M4G1H3,4811,155,18,51638,28.89,5,50.44,9
M4G3J1,4812,155,17,51655,28.89,5,50.44,9
M5N1G9,4813,155,15,51670,27.59,4,56.07,8
M4G1L9,4814,155,3,51673,28.89,1,50.43,2
M6G2V5,4815,155,57,51730,24.71,14,68.54,39
M4G1S2,4816,155,7,51737,28.89,2,50.43,4
M9A3N2,4817,155,10,51747,25.45,3,65.33,7
M8Z4K8,4818,155,2,51749,26.95,1,58.83,1
M2P1K5,4819,155,25,51774,24.93,6,67.57,17
M6S4C1,4820,155,30,51804,25.95,8,63.14,19
M6S4H7,4821,155,24,51828,25.95,6,63.14,15
M8Z4C7,4822,155,2,51830,26.95,1,58.81,1
M8Z2V5,4823,155,6,51836,26.95,2,58.81,4
M9A5B8,4824,155,1,51837,26.79,0,59.50,1
M5N2C6,4825,155,2,51839,27.59,1,56.03,1
M8Z4L2,4826,155,2,51841,26.95,1,58.80,1
M8Z2W1,4827,155,16,51857,26.95,4,58.80,9
M8Z2V8,4828,155,9,51866,26.95,2,58.80,5
M8Z2V2,4829,155,8,51874,26.95,2,58.80,5
M8Z2V4,4830,155,13,51887,26.95,4,58.79,8
M8Z2R9,4831,155,7,51894,26.95,2,58.79,4
M6S1T3,4832,155,2,51896,25.95,1,63.12,1
M6S1W4,4833,155,1,51897,25.95,0,63.12,1
M8Z4L1,4834,155,2,51899,26.95,1,58.78,1
M8Z4S1,4835,155,1,51900,26.95,0,58.77,1
M9B1W5,4836,155,1,51901,25.15,0,66.55,1
L3T3G6,4837,155,11,51912,28.53,3,51.89,6
M9R2S4,4838,155,1,51913,28.98,0,49.94,0
L3T3G9,4839,155,15,51928,28.53,4,51.89,8
L3T3G4,4840,155,21,51949,28.53,6,51.89,11
L3T3G3,4841,155,10,51959,28.53,3,51.89,5
L3T3H1,4842,155,15,51974,28.53,4,51.89,8
L3T3L6,4843,155,2,51976,28.53,1,51.88,1
M6S4Z7,4844,155,70,52046,28.90,20,50.27,35
M9R2S6,4845,155,2,52048,28.98,1,49.92,1
M9R1E2,4846,155,2,52050,28.98,1,49.90,1
L3T3L5,4847,155,2,52052,28.53,1,51.85,1
M9R1E5,4848,155,9,52061,28.98,3,49.89,4
M9R2S2,4849,155,5,52066,28.98,1,49.89,2
M9R2S9,4850,155,5,52071,28.98,1,49.89,2
M9R1E3,4851,155,19,52090,28.98,6,49.89,9
M9R2T3,4852,155,17,52107,28.98,5,49.89,8
M9R1C9,4853,155,18,52125,28.98,5,49.89,9
M9R1C8,4854,155,16,52141,28.98,5,49.89,8
M9B1R7,4855,155,2,52143,29.12,1,49.28,1
M9B1R3,4856,155,3,52146,29.12,1,49.25,1
M6B1A8,4857,155,5,52151,27.70,1,55.40,3
M6B1J4,4858,155,5,52156,27.70,1,55.40,3
M6B1J5,4859,155,4,52160,27.70,1,55.40,2
M6B3E8,4860,155,9,52169,27.70,2,55.40,5
M9B4C1,4861,155,12,52181,29.12,3,49.24,6
M6B3E9,4862,155,5,52186,27.70,1,55.39,3
M6B1A9,4863,155,6,52192,27.70,2,55.39,3
M6B1L8,4864,155,9,52201,27.70,2,55.39,5
M9B1T3,4865,155,7,52208,29.12,2,49.24,3
M6B1J2,4866,155,4,52212,27.70,1,55.39,2
M9B3L6,4867,155,11,52223,29.12,3,49.24,5
M9B4B9,4868,155,12,52235,29.12,3,49.24,6
M9B1T1,4869,155,5,52240,29.12,1,49.24,2
M6B1A7,4870,155,6,52246,27.70,2,55.39,3
M6B3G1,4871,155,7,52253,27.70,2,55.39,4
M6B1A6,4872,155,22,52275,27.70,6,55.39,12
M6B1L7,4873,155,11,52286,27.70,3,55.39,6
M6B3G5,4874,155,14,52300,27.70,4,55.39,8
M6C2K3,4875,155,18,52318,27.70,5,55.39,10
M6B3G4,4876,155,9,52327,27.70,2,55.39,5
M9B4E2,4877,155,12,52339,29.12,3,49.23,6
M6B1J6,4878,155,13,52352,27.70,4,55.39,7
M6B3E4,4879,155,7,52359,27.70,2,55.38,4
M6B3G2,4880,155,5,52364,27.70,1,55.38,3
M6B3G3,4881,155,7,52371,27.70,2,55.38,4
M9B1R5,4882,155,1,52372,29.12,0,49.22,0
M9B1T2,4883,155,2,52374,29.12,1,49.21,1
M6B3G6,4884,155,1,52375,27.70,0,55.33,1
M9A4N2,4885,155,2,52377,27.85,1,54.67,1
M9A4N6,4886,155,11,52388,27.85,3,54.65,6
L4J7B7,4887,155,10,52398,26.21,3,61.72,6
M4V2B1,4888,155,1,52399,25.76,0,63.66,1
L3T5N5,4889,155,19,52418,26.34,5,61.15,12
M5P1K7,4890,155,6,52424,24.89,1,67.43,4
M4X1H6,4891,155,39,52463,24.24,9,70.24,27
L3T2R5,4892,155,5,52468,23.55,1,73.23,4
L4J7V1,4893,155,31,52499,25.07,8,66.64,21
M9P1R8,4894,155,5,52504,25.11,1,66.44,3
M4V2C8,4895,155,4,52508,25.76,1,63.63,3
M9P3B4,4896,155,7,52515,25.11,2,66.44,5
M9P1R7,4897,155,7,52522,25.11,2,66.44,5
M9P1R5,4898,155,10,52532,25.11,3,66.44,7
M4V2A9,4899,155,6,52538,25.76,2,63.62,4
M9B2K7,4900,155,2,52540,25.64,1,64.14,1
M4V1W3,4901,155,14,52554,25.76,4,63.61,9
M4V1W5,4902,155,29,52583,25.76,7,63.61,18
M8X2N6,4903,155,1,52584,26.50,0,60.40,1
M9B2J1,4904,155,2,52586,25.64,1,64.12,1
M9B2J8,4905,155,2,52588,25.64,1,64.11,1
L3T1A7,4906,155,1,52589,23.55,0,73.17,1
M6C3K9,4907,155,8,52597,28.82,2,50.33,4
M9B2J3,4908,155,2,52599,25.64,1,64.10,1
M9B2C7,4909,155,2,52601,25.64,1,64.10,1
L4J4T1,4910,155,15,52616,26.80,4,59.07,9
M8X1V5,4911,155,4,52620,27.62,1,55.52,2
M9B4Y5,4912,155,12,52632,25.64,3,64.10,8
L4J4T8,4913,155,15,52647,26.80,4,59.07,9
M9B4Y6,4914,155,6,52653,25.64,2,64.09,4
M9B4X8,4915,155,5,52658,25.64,1,64.09,3
M8X2N9,4916,155,5,52663,27.62,1,55.51,3
M6C2Y8,4917,155,17,52680,28.82,5,50.31,9
M8X2S5,4918,155,4,52684,27.62,1,55.51,2
M6C1N2,4919,155,10,52694,28.82,3,50.31,5
M9B2J4,4920,155,2,52696,25.64,1,64.08,1
M8X2R6,4921,155,18,52714,27.62,5,55.50,10
M8X1T6,4922,155,10,52724,27.62,3,55.50,6
M8X2R8,4923,155,6,52730,27.62,2,55.50,3
M8X2R9,4924,155,15,52745,27.62,4,55.50,8
M8X1V7,4925,155,4,52749,27.62,1,55.50,2
M8X2P7,4926,155,15,52764,27.62,4,55.50,8
M9C5N4,4927,155,31,52795,28.50,9,51.68,16
M8X2P1,4928,155,3,52798,26.50,1,60.34,2
M9B2K9,4929,155,2,52800,25.64,1,64.06,1
M8X2M4,4930,155,10,52810,26.50,3,60.33,6
M8X1V1,4931,155,10,52820,26.50,3,60.32,6
M8X1T7,4932,155,2,52822,27.62,1,55.47,1
M8X1T9,4933,155,9,52831,26.50,2,60.32,5
M8X2M7,4934,155,9,52840,26.50,2,60.32,5
M8X1V3,4935,155,7,52847,26.50,2,60.31,4
M4N2Y6,4936,155,2,52849,26.69,1,59.43,1
M3H2V3,4937,155,5,52854,26.71,1,59.33,3
L3T4E2,4938,155,16,52870,26.97,4,58.21,9
M4N1Z3,4939,155,32,52902,26.69,9,59.42,19
M4N2A3,4940,155,31,52933,26.69,8,59.42,18
M4N2Y4,4941,155,2,52935,26.69,1,59.39,1
M4P1S4,4942,155,48,52983,25.78,12,63.32,30
M8Z4S3,4943,155,23,53006,26.82,6,58.80,14
M8W4N1,4944,155,9,53015,28.46,3,51.68,5
M3A3K9,4945,155,5,53020,25.67,1,63.76,3
M8W2H7,4946,155,15,53035,28.46,4,51.67,8
M3B3A5,4947,155,6,53041,26.83,2,58.73,4
L4J7S7,4948,155,39,53080,26.82,10,58.77,23
M3A3J3,4949,155,24,53104,25.67,6,63.74,15
M3A3J7,4950,155,35,53139,25.67,9,63.74,22
M3A3L2,4951,155,15,53154,25.67,4,63.74,10
M9N3H4,4952,155,5,53159,28.83,1,50.02,3
M9N2K1,4953,155,3,53162,28.83,1,50.02,2
M9N2K3,4954,155,5,53167,28.83,1,50.01,3
M5M2S2,4955,155,14,53181,28.69,4,50.62,7
M9N3E3,4956,155,7,53188,28.83,2,50.01,4
M9N2J9,4957,155,8,53196,28.83,2,50.01,4
M9N3A5,4958,155,14,53210,28.83,4,50.00,7
M9N3E2,4959,155,12,53222,28.83,3,50.00,6
M9N2J8,4960,155,1,53223,28.83,0,50.00,1
M9N3E1,4961,155,2,53225,28.83,1,50.00,1
M9N2K2,4962,155,6,53231,28.83,2,50.00,3
M9N3G6,4963,155,8,53239,28.83,2,50.00,4
M9N2L1,4964,155,3,53242,28.83,1,50.00,2
M9N3E9,4965,155,7,53249,28.83,2,50.00,4
M9N3E8,4966,155,10,53259,28.83,3,50.00,5
M9N3G5,4967,155,6,53265,28.83,2,49.99,3
M9A4B4,4968,155,4,53269,27.75,1,54.67,2
L4J6R7,4969,155,8,53277,28.05,2,53.37,4
M2N3A5,4970,155,3,53280,26.06,1,61.97,2
M5M4E7,4971,155,3,53283,26.48,1,60.14,2
M5N1V3,4972,155,2,53285,26.19,1,61.40,1
M5M4E8,4973,155,1,53286,26.48,0,60.14,1
M9N2K9,4974,155,1,53287,28.83,0,49.94,0
M5M1Z9,4975,155,23,53310,26.48,6,60.12,14
M5M1X1,4976,155,18,53328,26.48,5,60.12,11
M5M2C1,4977,155,19,53347,26.48,5,60.12,11
M4X1J8,4978,155,1,53348,24.15,0,70.21,1
M5M1Z8,4979,155,22,53370,26.48,6,60.12,13
M5M1X2,4980,155,21,53391,26.48,6,60.12,13
M5M2B9,4981,155,18,53409,26.48,5,60.12,11
M5M4J3,4982,155,8,53417,26.48,2,60.12,5
M5M1Z7,4983,155,17,53434,26.48,5,60.12,10
M5M1Z6,4984,155,14,53448,26.48,4,60.11,8
M5N2S6,4985,155,6,53454,26.19,2,61.37,4
M5N2T3,4986,155,7,53461,26.19,2,61.37,4
M5M4E6,4987,155,4,53465,26.48,1,60.11,2
M2N2J9,4988,155,7,53472,29.04,2,49.02,3
M5N2S7,4989,155,6,53478,26.19,2,61.36,4
M5N1X1,4990,155,4,53482,26.19,1,61.36,2
M5P1J2,4991,155,6,53488,27.47,2,55.79,3
M5P1J1,4992,155,7,53495,27.47,2,55.79,4
M5P2B2,4993,155,8,53503,27.47,2,55.78,4
M5P1H4,4994,155,7,53510,27.47,2,55.78,4
M5P2B3,4995,155,1,53511,27.47,0,55.78,1
M5P2E7,4996,155,17,53528,27.47,5,55.78,9
M5P2C5,4997,155,15,53543,27.47,4,55.78,8
M9B5L6,4998,155,2,53545,28.71,1,50.40,1
M9B5L7,4999,155,2,53547,28.71,1,50.40,1
M9B5M3,5000,155,2,53549,28.71,1,50.39,1
M5N1W7,5001,155,2,53551,26.19,1,61.31,1
M4X1T4,5002,155,1,53552,24.11,0,70.32,1
M9B5M5,5003,155,6,53558,28.71,2,50.39,3
M9B2Z8,5004,155,5,53563,28.71,1,50.39,3
M9B2T7,5005,155,6,53569,28.71,2,50.39,3
M9B5N4,5006,155,2,53571,28.71,1,50.38,1
M9B2S9,5007,155,4,53575,28.71,1,50.38,2
M9B2V5,5008,155,8,53583,28.71,2,50.38,4
M5R2K5,5009,155,9,53592,24.33,2,69.36,6
M9B2V4,5010,155,11,53603,28.71,3,50.38,6
M6S3K7,5011,155,10,53613,27.39,3,56.10,6
M9B5N7,5012,155,7,53620,28.71,2,50.38,4
M9B5J9,5013,155,6,53626,28.71,2,50.38,3
M9B2W5,5014,155,12,53638,28.71,3,50.38,6
M9B5M1,5015,155,17,53655,28.71,5,50.38,9
M9B2W4,5016,155,12,53667,28.71,3,50.38,6
M9B2Z4,5017,155,19,53686,28.71,5,50.38,10
M9B5N5,5018,155,3,53689,28.71,1,50.38,2
M5R2K6,5019,155,6,53695,24.33,1,69.35,4
M9B5M2,5020,155,16,53711,28.71,5,50.38,8
M9B4L8,5021,155,11,53722,28.71,3,50.38,6
M9B5N8,5022,155,10,53732,28.71,3,50.38,5
M9B2W6,5023,155,1,53733,28.71,0,50.38,1
M9B5L9,5024,155,2,53735,28.71,1,50.38,1
M9B2Y2,5025,155,9,53744,28.71,3,50.37,5
M5R1R3,5026,155,28,53772,24.33,7,69.35,19
M9B2T8,5027,155,6,53778,28.71,2,50.37,3
M5R1M4,5028,155,32,53810,24.33,8,69.35,22
M9B5M4,5029,155,3,53813,28.71,1,50.37,2
M5R1N4,5030,155,43,53856,24.33,10,69.34,30
M9B2Y3,5031,155,8,53864,28.71,2,50.37,4
M6S1H4,5032,155,7,53871,27.39,2,56.08,4
M9B5N2,5033,155,3,53874,28.71,1,50.37,2
M5R1R4,5034,155,7,53881,24.33,2,69.34,5
M6B0A3,5035,155,1,53882,27.03,0,57.64,1
M6B2H7,5036,155,19,53901,27.30,5,56.46,11
M4X1W1,5037,155,5,53906,24.11,1,70.26,4
M4X1V8,5038,155,3,53909,24.11,1,70.26,2
M4J2W3,5039,155,18,53927,25.84,5,62.76,11
M4K3H3,5040,155,32,53959,25.46,8,64.41,21
M4X1H9,5041,155,8,53967,24.11,2,70.25,6
M4J4G4,5042,155,6,53973,25.84,2,62.76,4
M4X1H4,5043,155,8,53981,24.11,2,70.25,6
M4X1E8,5044,155,12,53993,24.11,3,70.25,8
M4X1H3,5045,155,15,54008,24.11,4,70.25,11
M4W3A2,5046,155,21,54029,24.11,5,70.25,15
M4W3A3,5047,155,14,54043,24.11,3,70.25,10
M4X1S2,5048,155,10,54053,24.11,2,70.25,7
M4X1E7,5049,155,4,54057,24.11,1,70.24,3
M4X1J2,5050,155,7,54064,24.11,2,70.24,5
M4X1J1,5051,155,7,54071,24.11,2,70.24,5
M4X1S3,5052,155,10,54081,24.11,2,70.24,7
M4X1H8,5053,155,15,54096,24.11,4,70.24,11
M4X1H7,5054,155,15,54111,24.11,4,70.24,11
M4X1V3,5055,155,9,54120,24.11,2,70.24,6
M4G1Z8,5056,155,33,54153,28.71,9,50.30,17
M4X1J3,5057,155,8,54161,24.11,2,70.23,6
L4L7V9,5058,155,10,54171,26.41,3,60.26,6
L4L7W2,5059,155,18,54189,26.41,5,60.26,11
M4X1R1,5060,155,3,54192,24.11,1,70.22,2
M3A1L1,5061,155,4,54196,28.75,1,50.08,2
M4S1P1,5062,155,6,54202,24.60,1,68.06,4
M3A1P8,5063,155,3,54205,28.75,1,50.08,2
M3A1P4,5064,155,14,54219,28.75,4,50.08,7
M3A1N9,5065,155,11,54230,28.75,3,50.08,6
M3A1P1,5066,155,23,54253,28.75,7,50.07,12
M3A1N8,5067,155,9,54262,28.75,3,50.07,5
M3A2K1,5068,155,7,54269,28.75,2,50.07,4
M3A1N6,5069,155,22,54291,28.75,6,50.07,11
M3A1N4,5070,155,6,54297,28.75,2,50.07,3
M3A2L6,5071,155,11,54308,28.75,3,50.07,6
M2N2K7,5072,155,14,54322,26.80,4,58.52,8
M3A1L2,5073,155,13,54335,28.75,4,50.07,7
M3A1N7,5074,155,15,54350,28.75,4,50.07,8
M2N1S3,5075,155,13,54363,26.80,3,58.51,8
M2N1T2,5076,155,13,54376,26.80,3,58.51,8
M3A1N5,5077,155,4,54380,28.75,1,50.06,2
M2N1S2,5078,155,10,54390,26.80,3,58.51,6
M2N1P7,5079,155,10,54400,26.80,3,58.51,6
M2N1T3,5080,155,12,54412,26.80,3,58.51,7
M2N2L1,5081,155,10,54422,26.80,3,58.51,6
M3A2L7,5082,155,8,54430,28.75,2,50.06,4
M2N1T4,5083,155,14,54444,26.80,4,58.51,8
M2N1T1,5084,155,14,54458,26.80,4,58.50,8
M2N3A6,5085,155,1,54459,26.04,0,61.79,1
L3T5S1,5086,155,5,54464,25.95,1,62.14,3
M9A3G4,5087,155,17,54481,26.31,4,60.55,10
M9C2M7,5088,155,3,54484,25.56,1,63.77,2
M9C3P7,5089,154,3,54487,25.56,1,63.76,2
M9C2M6,5090,154,3,54490,25.56,1,63.76,2
M9C2M5,5091,154,4,54494,25.56,1,63.76,3
M9C3E8,5092,154,12,54506,25.56,3,63.75,8
M9C3P5,5093,154,17,54523,25.56,4,63.75,11
M9C3E9,5094,154,18,54541,25.56,5,63.75,11
M9C3E5,5095,154,9,54550,25.56,2,63.75,6
M3B1L8,5096,154,1,54551,26.40,0,60.10,1
M9C3H6,5097,154,11,54562,25.56,3,63.74,7
M9C4Y3,5098,154,17,54579,25.56,4,63.74,11
M9C3G1,5099,154,7,54586,25.56,2,63.74,4
M9C3E7,5100,154,2,54588,25.56,1,63.74,1
M9B4E1,5101,154,13,54601,28.90,4,49.24,6
M9B4E4,5102,154,7,54608,28.90,2,49.24,3
M9B4C3,5103,154,13,54621,28.90,4,49.24,6
M9B4E3,5104,154,11,54632,28.90,3,49.24,5
M9B3L9,5105,154,13,54645,28.90,4,49.24,6
M9C3P6,5106,154,2,54647,25.56,1,63.71,1
M3B2P7,5107,154,19,54666,26.40,5,60.06,11
M9B4C2,5108,154,12,54678,28.90,3,49.23,6
M5N2C9,5109,154,12,54690,27.32,3,56.08,7
M9B4G5,5110,154,8,54698,28.90,2,49.23,4
M9B4G3,5111,154,10,54708,28.90,3,49.23,5
M9B1T5,5112,154,6,54714,28.90,2,49.23,3
M5N2J5,5113,154,8,54722,27.32,2,56.07,4
M5N2J6,5114,154,9,54731,27.32,2,56.07,5
M5N1G7,5115,154,11,54742,27.32,3,56.07,6
M5N1G8,5116,154,15,54757,27.32,4,56.07,8
M5N1G3,5117,154,38,54795,27.32,10,56.07,21
M9B1T4,5118,154,4,54799,28.90,1,49.22,2
M5N2J8,5119,154,9,54808,27.32,2,56.07,5
M5N1G6,5120,154,14,54822,27.32,4,56.07,8
M5N1H2,5121,154,15,54837,27.32,4,56.06,8
M6B2Z9,5122,154,3,54840,27.91,1,53.49,2
M6C4A5,5123,154,1,54841,25.91,0,62.12,1
M6P3A6,5124,154,63,54904,25.15,16,65.40,41
L3T6Y6,5125,154,14,54918,25.61,4,63.38,9
L4L8E7,5126,154,32,54950,28.69,9,50.03,16
L4L8G1,5127,154,28,54978,28.69,8,50.03,14
M4G2A1,5128,154,15,54993,28.48,4,50.93,8
L3T5K5,5129,154,13,55006,25.74,3,62.79,8
L3T5J6,5130,154,9,55015,25.74,2,62.79,6
M4G2E1,5131,154,6,55021,28.48,2,50.92,3
M3B1M7,5132,154,7,55028,26.23,2,60.66,4
L4J5C8,5133,154,11,55039,26.43,3,59.79,7
L4J5E2,5134,154,11,55050,26.43,3,59.78,7
M2P1L1,5135,154,17,55067,28.15,5,52.33,9
L3T3G2,5136,154,16,55083,28.25,5,51.90,8
M2P1Z2,5137,154,4,55087,28.15,1,52.33,2
M2P1Z4,5138,154,18,55105,28.15,5,52.33,9
M2P1Z1,5139,154,18,55123,28.15,5,52.32,9
M2P1L2,5140,154,19,55142,28.15,5,52.32,10
M2P1T1,5141,154,2,55144,28.15,1,52.31,1
M6S3M6,5142,154,35,55179,27.07,9,56.99,20
M2P1Z5,5143,154,4,55183,28.15,1,52.30,2
M2P1N4,5144,154,2,55185,28.15,1,52.30,1
L3T1A5,5145,154,19,55204,26.48,5,59.51,11
L3T2K2,5146,154,3,55207,26.48,1,59.51,2
M2P1N5,5147,154,2,55209,28.15,1,52.28,1
L3T1C2,5148,154,20,55229,26.48,5,59.51,12
M5N1V8,5149,154,1,55230,22.31,0,77.57,1
M4G0A7,5150,154,82,55312,25.09,21,65.50,54
M6S2W7,5151,154,7,55319,25.23,2,64.89,5
M6S2X3,5152,154,5,55324,25.23,1,64.89,3
M6S2W4,5153,154,5,55329,25.23,1,64.89,3
M6S2W5,5154,154,22,55351,25.23,6,64.88,14
M6S2V7,5155,154,17,55368,25.23,4,64.88,11
M6S2V1,5156,154,7,55375,25.23,2,64.88,5
M6S2X1,5157,154,7,55382,25.23,2,64.88,5
M6S2W3,5158,154,11,55393,25.23,3,64.88,7
M6S2T9,5159,154,11,55404,25.23,3,64.88,7
L4L2S4,5160,154,26,55430,27.54,7,54.87,14
M6S2W6,5161,154,15,55445,25.23,4,64.88,10
M6S1A6,5162,154,11,55456,25.23,3,64.88,7
M6S2V4,5163,154,10,55466,25.23,3,64.88,6
M4X1H1,5164,154,20,55486,23.99,5,70.25,14
M6S3C7,5165,154,4,55490,25.23,1,64.87,3
M9W2G9,5166,154,1,55491,28.57,0,50.34,1
L3T6W3,5167,154,17,55508,25.56,4,63.38,11
L3T6V7,5168,154,9,55517,25.56,2,63.38,6
L4L2L2,5169,154,7,55524,27.52,2,54.87,4
M6B1T8,5170,154,8,55532,26.16,2,60.75,5
L3T5M9,5171,154,12,55544,26.34,3,59.97,7
M6B2H9,5172,154,14,55558,26.16,4,60.75,9
M6B1Z7,5173,154,16,55574,26.16,4,60.74,10
M6B2C7,5174,154,16,55590,26.16,4,60.74,10
M6B2A1,5175,154,12,55602,26.16,3,60.74,7
M6B2C6,5176,154,20,55622,26.16,5,60.74,12
M6B1X8,5177,154,15,55637,26.16,4,60.74,9
M6B1X9,5178,154,10,55647,26.16,3,60.74,6
M6B2C8,5179,154,16,55663,26.16,4,60.73,10
M9W2G8,5180,154,2,55665,28.57,1,50.29,1
M6B1Y1,5181,154,10,55675,26.16,3,60.73,6
M6B1Z9,5182,154,11,55686,26.16,3,60.73,7
M3B2Y4,5183,154,11,55697,26.53,3,59.13,7
M9R1G1,5184,154,3,55700,28.58,1,50.23,2
M9R1E6,5185,154,11,55711,28.58,3,50.22,6
M9R1E8,5186,154,7,55718,28.58,2,50.22,4
L4H1K2,5187,154,39,55757,28.32,11,51.34,20
M8Z3H7,5188,154,14,55771,25.80,4,62.24,9
M9B4A8,5189,154,1,55772,25.98,0,61.42,1
M8X1V8,5190,154,5,55777,27.34,1,55.50,3
M9B5G6,5191,154,3,55780,27.33,1,55.54,2
M9A1V5,5192,154,8,55788,26.25,2,60.22,5
M9A1T9,5193,154,10,55798,26.25,3,60.22,6
M9A1W3,5194,154,9,55807,26.25,2,60.22,5
M9A1T4,5195,154,10,55817,26.25,3,60.22,6
M9A1T5,5196,154,17,55834,26.25,4,60.22,10
M9A1V1,5197,154,10,55844,26.25,3,60.22,6
M9A1R7,5198,154,17,55861,26.25,4,60.22,10
M9A1S9,5199,154,14,55875,26.25,4,60.22,8
M9A2M2,5200,154,5,55880,26.25,1,60.22,3
M9B3N2,5201,154,5,55885,26.25,1,60.21,3
M9B3N4,5202,154,10,55895,26.25,3,60.21,6
M9A1V4,5203,154,9,55904,26.25,2,60.21,5
M9A1W5,5204,154,15,55919,26.25,4,60.21,9
M9B2M8,5205,154,4,55923,27.33,1,55.53,2
M9A1S8,5206,154,11,55934,26.25,3,60.21,7
M9A2L9,5207,154,3,55937,26.25,1,60.21,2
M9A1S3,5208,154,6,55943,26.25,2,60.21,4
M9B5G7,5209,154,2,55945,27.33,1,55.53,1
L3T1H8,5210,154,2,55947,27.12,1,56.44,1
M9B5E9,5211,154,11,55958,27.33,3,55.53,6
M9B2M6,5212,154,2,55960,27.33,1,55.52,1
M9B2N8,5213,154,8,55968,27.33,2,55.52,4
M9B2T2,5214,154,13,55981,27.33,4,55.52,7
M9B5G1,5215,154,14,55995,27.33,4,55.52,8
M9B2M5,5216,154,7,56002,27.33,2,55.52,4
M9B2M4,5217,154,13,56015,27.33,4,55.52,7
M9B3N5,5218,154,17,56032,27.33,5,55.52,9
M9B2T9,5219,154,14,56046,27.33,4,55.52,8
M9B5H5,5220,154,16,56062,27.33,4,55.52,9
M9B2M7,5221,154,6,56068,27.33,2,55.52,3
M9B3N3,5222,154,8,56076,27.33,2,55.52,4
M9B2T1,5223,154,11,56087,27.33,3,55.52,6
M9B2N7,5224,154,19,56106,27.33,5,55.51,11
M9B5G5,5225,154,3,56109,27.33,1,55.51,2
M2N1G4,5226,154,26,56135,27.53,7,54.65,14
M4T1K5,5227,154,2,56137,25.96,1,61.45,1
M9R4A5,5228,154,1,56138,28.58,0,50.09,1
M9A2M6,5229,154,1,56139,26.25,0,60.19,1
M9B2N1,5230,154,2,56141,27.33,1,55.49,1
M9B2K8,5231,154,2,56143,27.33,1,55.49,1
M6P2V9,5232,154,57,56200,23.29,13,73.00,42
M9B3N6,5233,154,2,56202,27.33,1,55.49,1
M4T2G1,5234,154,8,56210,25.96,2,61.43,5
M4T1R3,5235,154,5,56215,25.96,1,61.42,3
M9B5G3,5236,154,3,56218,27.33,1,55.49,2
M4T1K6,5237,154,4,56222,25.96,1,61.42,2
M4T1K8,5238,154,28,56250,25.96,7,61.42,17
M4T1K7,5239,154,29,56279,25.96,8,61.42,18
M4T2E8,5240,154,9,56288,25.96,2,61.42,6
M4T1P3,5241,154,41,56329,25.96,11,61.42,25
M9A1S7,5242,154,1,56330,26.25,0,60.16,1
M4T1P2,5243,154,7,56337,25.96,2,61.42,4
M4T1H8,5244,154,27,56364,25.96,7,61.42,17
M4T1P1,5245,154,6,56370,25.96,2,61.41,4
M4T2E7,5246,154,3,56373,25.96,1,61.41,2
M8X1L1,5247,154,7,56380,27.51,2,54.69,4
M4T2J1,5248,154,1,56381,25.96,0,61.40,1
M8X2P5,5249,154,5,56386,27.51,1,54.68,3
M9B5G2,5250,154,2,56388,27.33,1,55.46,1
M8X1K8,5251,154,6,56394,27.51,2,54.68,3
M8X2L4,5252,154,6,56400,27.51,2,54.67,3
M8X2P6,5253,154,9,56409,27.51,2,54.67,5
M8X2M9,5254,154,9,56418,27.51,2,54.67,5
M8X2L6,5255,154,12,56430,27.51,3,54.67,7
M8X1V6,5256,154,1,56431,27.32,0,55.49,1
M8X1K9,5257,154,7,56438,27.51,2,54.67,4
M8X2N3,5258,154,8,56446,27.51,2,54.67,4
M8X2N2,5259,154,10,56456,27.51,3,54.67,5
L4L2H5,5260,154,6,56462,26.64,2,58.43,4
L4L1S4,5261,154,15,56477,26.64,4,58.43,9
L4L2J5,5262,154,12,56489,26.64,3,58.43,7
M8X2N7,5263,154,11,56500,27.51,3,54.66,6
M8X2N1,5264,154,9,56509,27.51,2,54.66,5
M9P1R3,5265,154,9,56518,24.79,2,66.44,6
M9P2X7,5266,154,8,56526,24.79,2,66.44,5
M8X2N8,5267,154,9,56535,27.51,2,54.66,5
M9P2X5,5268,154,5,56540,24.79,1,66.44,3
M9P1K4,5269,154,4,56544,24.79,1,66.44,3
M9P1E8,5270,154,2,56546,24.79,0,66.44,1
M8X1K7,5271,154,7,56553,27.51,2,54.66,4
M9B1Y1,5272,154,1,56554,28.33,0,51.10,1
M9P1P7,5273,154,15,56569,24.79,4,66.44,10
M9P1E7,5274,154,9,56578,24.79,2,66.44,6
M9P1R6,5275,154,11,56589,24.79,3,66.44,7
M9P1E5,5276,154,29,56618,24.79,7,66.44,19
M8X1K6,5277,154,6,56624,27.51,2,54.65,3
M4T2C4,5278,154,1,56625,25.96,0,61.36,1
M9P2X6,5279,154,10,56635,24.79,2,66.43,7
M9P1G1,5280,154,3,56638,24.79,1,66.43,2
M9B1V7,5281,154,1,56639,28.33,0,51.07,1
M4N1C2,5282,154,3,56642,26.96,1,57.00,2
M9B1V8,5283,154,1,56643,28.33,0,51.07,1
M9B1V6,5284,154,1,56644,28.33,0,51.07,1
M9B1X8,5285,154,3,56647,28.33,1,51.06,2
M2R1P6,5286,154,3,56650,26.44,1,59.25,2
M2N1Z2,5287,154,10,56660,26.44,3,59.24,6
M4N1E6,5288,154,7,56667,26.96,2,56.99,4
M4N1C5,5289,154,6,56673,26.96,2,56.99,3
M4N2X6,5290,154,3,56676,26.96,1,56.99,2
M2N1Y5,5291,154,9,56685,26.44,2,59.24,5
M4N1G5,5292,154,10,56695,26.96,3,56.98,6
M2N1Z3,5293,154,29,56724,26.44,8,59.24,17
M4N1B7,5294,154,11,56735,26.96,3,56.98,6
M4N2P5,5295,154,9,56744,26.96,2,56.98,5
M4N1B9,5296,154,32,56776,26.96,9,56.98,18
M4N1C1,5297,154,6,56782,26.96,2,56.98,3
M2N1Y4,5298,154,39,56821,26.44,10,59.23,23
M4N1A6,5299,154,7,56828,26.96,2,56.98,4
M2N2P7,5300,154,7,56835,26.44,2,59.23,4
M4N1A4,5301,154,20,56855,26.96,5,56.98,11
M4N1E7,5302,154,8,56863,26.96,2,56.98,5
M4N1B6,5303,154,15,56878,26.96,4,56.98,9
M2N2P6,5304,154,7,56885,26.44,2,59.23,4
M2N2N9,5305,154,7,56892,26.44,2,59.23,4
M9B1Y3,5306,154,1,56893,28.33,0,51.04,1
M4N1E9,5307,154,10,56903,26.96,3,56.98,6
M4N2P3,5308,154,9,56912,26.96,2,56.98,5
M4N1C3,5309,154,6,56918,26.96,2,56.98,3
M4N1C4,5310,154,7,56925,26.96,2,56.98,4
M4N1G1,5311,154,6,56931,26.96,2,56.98,3
M2N2A7,5312,154,13,56944,26.44,3,59.23,8
M9B1V5,5313,154,3,56947,28.33,1,51.04,2
M4N2X7,5314,154,3,56950,26.96,1,56.98,2
M8Z4S4,5315,154,8,56958,26.54,2,58.79,5
M9B4S1,5316,154,14,56972,28.33,4,51.04,7
M9B4S7,5317,154,7,56979,28.33,2,51.03,4
M9B1S3,5318,154,8,56987,28.33,2,51.03,4
M9B4L5,5319,154,12,56999,28.51,3,50.25,6
M9B4S5,5320,154,25,57024,28.33,7,51.03,13
M9B4R7,5321,154,8,57032,28.33,2,51.03,4
M9B4S6,5322,154,21,57053,28.33,6,51.03,11
M9B4T3,5323,154,8,57061,28.33,2,51.03,4
M9B4R8,5324,154,6,57067,28.33,2,51.03,3
M4N2Z7,5325,154,2,57069,26.96,1,56.96,1
M9R2P9,5326,154,32,57101,28.59,9,49.89,16
M9R2T2,5327,154,22,57123,28.59,6,49.89,11
M9R1E1,5328,154,17,57140,28.59,5,49.89,8
M9R1C7,5329,154,27,57167,28.59,8,49.89,13
M9R2T1,5330,154,8,57175,28.59,2,49.89,4
M9R2S7,5331,154,2,57177,28.59,1,49.88,1
M9R2S5,5332,154,13,57190,28.59,4,49.88,6
M2N1Y3,5333,154,26,57216,26.43,7,59.24,15
M4N2Z6,5334,154,12,57228,26.95,3,56.98,7
M4N1G3,5335,154,7,57235,26.95,2,56.98,4
M9R1E4,5336,154,2,57237,28.59,1,49.87,1
M4G2J7,5337,154,20,57257,24.02,5,69.62,14
M4G2J6,5338,154,18,57275,24.02,4,69.62,13
M4G2M6,5339,154,12,57287,24.02,3,69.62,8
M4G2K8,5340,154,16,57303,24.02,4,69.62,11
M4G1K3,5341,154,8,57311,24.02,2,69.62,6
M4G1K2,5342,154,10,57321,24.02,2,69.61,7
M4G2J8,5343,154,16,57337,24.02,4,69.61,11
M4G2J9,5344,154,16,57353,24.02,4,69.61,11
M4G1R1,5345,154,4,57357,24.02,1,69.60,3
M5M1G9,5346,154,15,57372,25.96,4,61.18,9
M5P1T8,5347,154,2,57374,23.81,0,70.48,1
M4S1H2,5348,154,7,57381,24.83,2,66.05,5
L4J7C6,5349,154,15,57396,25.39,4,63.62,10
M6B3C8,5350,154,1,57397,26.45,0,59.01,1
M6B1Z6,5351,154,14,57411,26.45,4,59.00,8
M6B1Z3,5352,154,11,57422,26.45,3,59.00,6
M6B1X5,5353,154,16,57438,26.45,4,59.00,9
M5N1H6,5354,154,8,57446,28.08,2,51.94,4
M6B1X6,5355,154,17,57463,26.45,4,59.00,10
M6B1X3,5356,154,15,57478,26.45,4,59.00,9
M5N1K6,5357,154,4,57482,28.08,1,51.93,2
M5N2K3,5358,154,29,57511,28.08,8,51.93,15
M5N1H4,5359,154,6,57517,28.08,2,51.93,3
M5N2L4,5360,154,30,57547,28.08,8,51.93,16
M5N2K9,5361,154,19,57566,28.08,5,51.93,10
M5N2K4,5362,154,22,57588,28.08,6,51.93,11
M4P2N9,5363,154,6,57594,25.45,2,63.32,4
M5N1K2,5364,154,10,57604,28.08,3,51.93,5
M5N2L3,5365,154,26,57630,28.08,7,51.93,14
M5N2K8,5366,154,30,57660,28.08,8,51.93,16
M5N2J7,5367,154,21,57681,28.08,6,51.93,11
M5N2M3,5368,154,24,57705,28.08,7,51.93,12
M5N1K3,5369,154,6,57711,28.08,2,51.92,3
M8Z3E9,5370,154,1,57712,27.96,0,52.44,1
M4N1Z1,5371,154,30,57742,26.35,8,59.41,18
M4N1Z4,5372,154,32,57774,26.35,8,59.41,19
M4S2S7,5373,154,33,57807,26.41,9,59.15,20
M5N1K1,5374,154,5,57812,28.08,1,51.91,3
M4S2P4,5375,154,31,57843,26.41,8,59.15,18
M3B1A6,5376,154,3,57846,26.21,1,60.01,2
M3B1E2,5377,154,3,57849,26.21,1,60.01,2
M4S1W8,5378,154,10,57859,26.41,3,59.15,6
M3B1G6,5379,154,9,57868,26.21,2,60.01,5
M3B2P2,5380,154,2,57870,26.21,1,60.01,1
M3B3R2,5381,154,2,57872,26.21,1,60.01,1
M3B2P5,5382,154,12,57884,26.21,3,60.01,7
M4S1W9,5383,154,12,57896,26.41,3,59.14,7
M3B2N5,5384,154,3,57899,26.21,1,60.01,2
L4L1P9,5385,154,4,57903,28.56,1,49.82,2
M3B2P4,5386,154,19,57922,26.21,5,60.00,11
M3B1K6,5387,154,13,57935,26.21,3,60.00,8
M3B1L6,5388,154,10,57945,26.21,3,60.00,6
M3B1K8,5389,154,31,57976,26.21,8,60.00,19
M3B1B7,5390,154,25,58001,26.21,7,60.00,15
M3B1J7,5391,154,17,58018,26.21,4,60.00,10
M3B2P6,5392,154,3,58021,26.21,1,60.00,2
M3B2N2,5393,154,15,58036,26.21,4,60.00,9
M3B1J4,5394,154,6,58042,26.21,2,60.00,4
M3B3R3,5395,154,1,58043,26.21,0,60.00,1
M3B1G7,5396,154,8,58051,26.21,2,60.00,5
M3B1K5,5397,154,20,58071,26.21,5,60.00,12
M3B1J6,5398,154,26,58097,26.21,7,60.00,16
M3B1K1,5399,154,9,58106,26.21,2,60.00,5
M3B1B1,5400,154,8,58114,26.21,2,60.00,5
M3B2V6,5401,154,8,58122,26.21,2,60.00,5
L4L7S6,5402,154,17,58139,26.35,4,59.39,10
M3B1L5,5403,154,10,58149,26.21,3,60.00,6
M3B1K7,5404,154,20,58169,26.21,5,60.00,12
M3B2S1,5405,154,20,58189,26.21,5,60.00,12
M3B2V5,5406,154,7,58196,26.21,2,59.99,4
M3B1K2,5407,154,9,58205,26.21,2,59.99,5
M3B1J5,5408,154,9,58214,26.21,2,59.99,5
M3B2N4,5409,154,7,58221,26.21,2,59.99,4
M3B2M9,5410,154,2,58223,26.21,1,59.99,1
M3B2N1,5411,154,4,58227,26.21,1,59.99,2
M3B2P3,5412,154,5,58232,26.21,1,59.99,3
M3H1W3,5413,154,12,58244,26.36,3,59.33,7
M3B1J8,5414,154,3,58247,26.21,1,59.98,2
M3B1A7,5415,154,3,58250,26.21,1,59.98,2
M3H1W6,5416,154,14,58264,26.36,4,59.33,8
M3H3B1,5417,154,14,58278,26.36,4,59.33,8
M3H1Z8,5418,154,9,58287,26.36,2,59.32,5
M3H1W8,5419,154,13,58300,26.36,3,59.32,8
M3H1W7,5420,154,14,58314,26.36,4,59.32,8
M3H2X4,5421,154,2,58316,26.36,1,59.32,1
M9A3G7,5422,154,10,58326,26.25,3,59.80,6
M3H2B4,5423,154,5,58331,26.36,1,59.32,3
M6S3Z8,5424,154,34,58365,26.09,9,60.47,21
M8Z4V9,5425,154,8,58373,25.69,2,62.19,5
M2K2V4,5426,154,12,58385,23.54,3,71.49,9
M9P3K5,5427,154,2,58387,26.37,1,59.23,1
M2K2V7,5428,154,10,58397,23.54,2,71.48,7
M2K2V5,5429,154,30,58427,23.54,7,71.48,21
M2K2W7,5430,154,14,58441,23.54,3,71.48,10
L3T1V3,5431,154,3,58444,25.52,1,62.90,2
M2K1S2,5432,154,28,58472,23.54,7,71.48,20
M2K2W3,5433,154,13,58485,23.54,3,71.48,9
M6S1M1,5434,154,4,58489,26.47,1,58.78,2
M9P3K4,5435,154,3,58492,26.37,1,59.21,2
M6S4H9,5436,154,10,58502,26.47,3,58.77,6
M6S4J4,5437,154,7,58509,26.47,2,58.77,4
M6S4B2,5438,154,34,58543,26.47,9,58.77,20
M9P2C3,5439,154,14,58557,26.37,4,59.20,8
M9P2E8,5440,154,7,58564,26.37,2,59.20,4
M6S4H8,5441,154,24,58588,26.47,6,58.76,14
M9P3H3,5442,154,3,58591,26.37,1,59.20,2
M6S4J5,5443,154,11,58602,26.47,3,58.76,6
M9P3K1,5444,154,15,58617,26.37,4,59.20,9
M2K2Y1,5445,154,1,58618,23.54,0,71.45,1
M9P2E4,5446,154,17,58635,26.37,4,59.19,10
M9P2C8,5447,154,4,58639,26.37,1,59.19,2
M9P2C4,5448,154,32,58671,26.37,8,59.19,19
M9P2C6,5449,154,13,58684,26.37,3,59.19,8
M9P2G1,5450,154,17,58701,26.37,4,59.19,10
M9P2E5,5451,154,14,58715,26.37,4,59.19,8
M9P2C9,5452,154,6,58721,26.37,2,59.18,4
M6S4J6,5453,154,1,58722,26.47,0,58.74,1
M6S1G7,5454,154,3,58725,26.47,1,58.74,2
M5N1V6,5455,154,4,58729,25.86,1,61.37,2
M9P2E6,5456,154,2,58731,26.37,1,59.16,1
M6S4J3,5457,154,1,58732,26.47,0,58.72,1
M9P3H1,5458,154,1,58733,26.37,0,59.15,1
M2K1R8,5459,154,6,58739,23.52,1,71.49,4
M9P2C5,5460,154,2,58741,26.37,1,59.14,1
L4L7S5,5461,154,11,58752,26.31,3,59.40,7
L4L7T4,5462,154,18,58770,26.31,5,59.40,11
M2K1J9,5463,154,11,58781,23.52,3,71.48,8
M2K1K4,5464,154,10,58791,23.52,2,71.48,7
L4J2J4,5465,153,2,58793,26.33,1,59.30,1
L4J5B3,5466,153,9,58802,26.33,2,59.29,5
L4J5E3,5467,153,14,58816,26.33,4,59.28,8
L4J1C3,5468,153,10,58826,26.33,3,59.28,6
M5M3X1,5469,153,2,58828,27.28,1,55.17,1
L4J5C4,5470,153,18,58846,26.33,5,59.28,11
L4J1C2,5471,153,10,58856,26.33,3,59.28,6
L4J5B6,5472,153,18,58874,26.33,5,59.28,11
L4J2J2,5473,153,4,58878,26.33,1,59.28,2
L4J5C9,5474,153,14,58892,26.33,4,59.28,8
M5M3W9,5475,153,5,58897,27.28,1,55.16,3
L4J5C1,5476,153,16,58913,26.33,4,59.28,9
L4J5C5,5477,153,9,58922,26.33,2,59.28,5
L4J5B5,5478,153,10,58932,26.33,3,59.28,6
L4J5B9,5479,153,18,58950,26.33,5,59.28,11
L4J5C6,5480,153,11,58961,26.33,3,59.28,7
L4J5C2,5481,153,10,58971,26.33,3,59.28,6
L4J5B8,5482,153,8,58979,26.33,2,59.28,5
L4J5B7,5483,153,18,58997,26.33,5,59.27,11
L4J5C3,5484,153,11,59008,26.33,3,59.27,7
M4V2L4,5485,153,7,59015,26.54,2,58.35,4
M6S1E7,5486,153,7,59022,27.05,2,56.11,4
L4J2K3,5487,153,1,59023,26.33,0,59.23,1
M6S3K6,5488,153,9,59032,27.05,2,56.11,5
M6S1H3,5489,153,9,59041,27.05,2,56.10,5
M9B3K2,5490,153,1,59042,28.54,0,49.65,0
M9B3A3,5491,153,1,59043,28.54,0,49.65,0
M4W2S7,5492,153,8,59051,23.29,2,72.39,6
M6S1E5,5493,153,9,59060,27.05,2,56.10,5
M9B3K6,5494,153,2,59062,28.54,1,49.64,1
M6S1E8,5495,153,4,59066,27.05,1,56.10,2
M6S3K5,5496,153,9,59075,27.05,2,56.10,5
M6S1E9,5497,153,5,59080,27.05,1,56.10,3
M6S3W7,5498,153,22,59102,27.05,6,56.09,12
M6S3K3,5499,153,10,59112,27.05,3,56.09,6
M6S1E6,5500,153,16,59128,27.05,4,56.09,9
M6S1C9,5501,153,8,59136,27.05,2,56.09,4
M6S1G3,5502,153,11,59147,27.05,3,56.09,6
M6S3W8,5503,153,9,59156,27.05,2,56.09,5
M6S1E2,5504,153,10,59166,27.05,3,56.09,6
M9B5W6,5505,153,5,59171,28.54,1,49.63,2
M9B4L9,5506,153,2,59173,28.54,1,49.63,1
M9B3K4,5507,153,2,59175,28.54,1,49.62,1
M9B5R9,5508,153,6,59181,28.54,2,49.62,3
M9B5S1,5509,153,28,59209,28.54,8,49.62,14
M9B5S2,5510,153,11,59220,28.54,3,49.62,5
M9B3K5,5511,153,9,59229,28.54,3,49.62,4
M9B3K3,5512,153,12,59241,28.54,3,49.62,6
M9B2W8,5513,153,19,59260,28.54,5,49.62,9
L3T5M1,5514,153,14,59274,26.15,4,59.97,8
M9B2X6,5515,153,16,59290,28.54,5,49.62,8
M9B5V4,5516,153,27,59317,28.54,8,49.62,13
M9B3K8,5517,153,8,59325,28.54,2,49.62,4
M9B6B1,5518,153,20,59345,28.54,6,49.62,10
M9B3B1,5519,153,24,59369,28.54,7,49.62,12
L3T4E4,5520,153,25,59394,26.47,7,58.58,15
M9B3J1,5521,153,20,59414,28.54,6,49.62,10
M9B5W2,5522,153,17,59431,28.54,5,49.62,8
M9B3A2,5523,153,12,59443,28.54,3,49.62,6
M9B5R2,5524,153,8,59451,28.54,2,49.61,4
M9B3K7,5525,153,16,59467,28.54,5,49.61,8
L3T5M8,5526,153,19,59486,26.15,5,59.97,11
L3T5M2,5527,153,11,59497,26.15,3,59.96,7
M9B5W5,5528,153,5,59502,28.54,1,49.61,2
M9B3H5,5529,153,1,59503,28.54,0,49.61,0
M9B5R5,5530,153,3,59506,28.54,1,49.60,1
M9B5R8,5531,153,2,59508,28.54,1,49.60,1
M9R1B7,5532,153,2,59510,28.28,1,50.72,1
M4P1S9,5533,153,40,59550,25.45,10,62.98,25
M9B2W1,5534,153,1,59551,28.36,0,50.34,1
M4P1T1,5535,153,29,59580,25.44,7,62.98,18
M9B5N6,5536,153,1,59581,28.36,0,50.33,1
M4P2N2,5537,153,3,59584,25.44,1,62.97,2
L4J6J6,5538,153,18,59602,25.01,5,64.82,12
M6B2T5,5539,153,12,59614,28.39,3,50.11,6
M6B2M6,5540,153,6,59620,28.39,2,50.11,3
L3T5J8,5541,153,23,59643,25.61,6,62.13,14
M8V1P4,5542,153,5,59648,24.38,1,67.46,3
M6B3C3,5543,153,1,59649,26.63,0,57.70,1
M6S5A7,5544,153,64,59713,24.97,16,64.88,42
M9P2T8,5545,153,3,59716,25.80,1,61.28,2
M4K2N5,5546,153,3,59719,26.40,1,58.68,2
M2N1G7,5547,153,22,59741,27.56,6,53.65,12
M9P1X7,5548,153,3,59744,25.80,1,61.28,2
M6B1A3,5549,153,11,59755,26.63,3,57.68,6
L4J7C3,5550,153,18,59773,25.49,5,62.61,11
M9B1P1,5551,153,2,59775,28.36,1,50.18,1
M6B1H2,5552,153,11,59786,26.63,3,57.67,6
M6B1H3,5553,153,11,59797,26.63,3,57.67,6
M6B1H7,5554,153,10,59807,26.63,3,57.67,6
M6B1A1,5555,153,3,59810,26.63,1,57.67,2
M6B1H1,5556,153,6,59816,26.63,2,57.66,3
M6B1G9,5557,153,4,59820,26.63,1,57.66,2
M6B1H5,5558,153,5,59825,26.63,1,57.66,3
M4K3C1,5559,153,4,59829,26.40,1,58.65,2
M9P1Y2,5560,153,1,59830,25.80,0,61.25,1
M4K1E5,5561,153,20,59850,26.40,5,58.65,12
M9N2M3,5562,153,3,59853,28.39,1,50.03,2
M8Z2J5,5563,153,16,59869,28.37,5,50.11,8
M6S3R4,5564,153,39,59908,27.06,11,55.77,22
M5M3G6,5565,153,9,59917,25.42,2,62.88,6
M9N3A6,5566,153,9,59926,28.39,3,50.01,5
M9N3A2,5567,153,11,59937,28.39,3,50.00,6
M9N3A3,5568,153,14,59951,28.39,4,50.00,7
M9N3E5,5569,153,11,59962,28.39,3,50.00,6
M9N3A7,5570,153,12,59974,28.39,3,50.00,6
M9N2Z7,5571,153,11,59985,28.39,3,50.00,6
M5M1X9,5572,153,5,59990,27.77,1,52.67,3
M5M2A6,5573,153,5,59995,27.77,1,52.66,3
M5M2A1,5574,153,19,60014,27.77,5,52.66,10
M5M1V2,5575,153,18,60032,27.77,5,52.66,9
M5M2A5,5576,153,7,60039,27.77,2,52.66,4
M5M2C6,5577,153,7,60046,27.77,2,52.65,4
M5M2A3,5578,153,14,60060,27.77,4,52.65,7
M5M1Y2,5579,153,13,60073,27.77,4,52.65,7
M5M2A4,5580,153,14,60087,27.77,4,52.65,7
M5M2C5,5581,153,16,60103,27.77,4,52.65,8
M5M1Y1,5582,153,13,60116,27.77,4,52.65,7
M5M2A2,5583,153,20,60136,27.77,6,52.65,11
M5M1X5,5584,153,13,60149,27.77,4,52.65,7
L4J7R6,5585,153,38,60187,24.86,9,65.25,25
M5M2C2,5586,153,15,60202,27.77,4,52.64,8
M5R1Z2,5587,153,4,60206,25.62,1,61.96,2
M5M4J1,5588,153,5,60211,27.77,1,52.64,3
M8V2M9,5589,153,2,60213,24.37,0,67.37,1
M5M1Y3,5590,153,6,60219,27.77,2,52.64,3
M5R1Y4,5591,153,1,60220,25.62,0,61.94,1
M5R1Y6,5592,153,10,60230,25.62,3,61.94,6
M5R3A6,5593,153,18,60248,25.62,5,61.94,11
M5R1Z6,5594,153,5,60253,25.62,1,61.94,3
M5R3E7,5595,153,29,60282,25.62,7,61.94,18
M5R2Z7,5596,153,19,60301,25.62,5,61.94,12
M5R1Z5,5597,153,6,60307,25.62,2,61.93,4
M5R1Y5,5598,153,8,60315,25.62,2,61.93,5
M5R2A1,5599,153,9,60324,25.62,2,61.93,6
M4K3B8,5600,153,16,60340,24.92,4,64.95,10
M4K1C2,5601,153,68,60408,24.92,17,64.94,44
M6S3T7,5602,153,16,60424,28.32,5,50.21,8
M6S1Z5,5603,153,1,60425,27.81,0,52.42,1
M6S1E3,5604,153,18,60443,28.32,5,50.21,9
M8W4R1,5605,153,13,60456,29.45,4,45.31,6
M8W4R7,5606,153,21,60477,29.45,6,45.31,10
M6S4B1,5607,153,15,60492,28.32,4,50.20,8
M6S1G5,5608,153,5,60497,28.32,1,50.20,3
M6S1E4,5609,153,2,60499,28.32,1,50.20,1
M6S1G4,5610,153,7,60506,28.32,2,50.19,4
M4S1X6,5611,153,7,60513,25.73,2,61.41,4
M4S2W7,5612,153,7,60520,25.73,2,61.41,4
M4S2Y3,5613,153,23,60543,25.73,6,61.40,14
M4S2X5,5614,153,28,60571,25.73,7,61.40,17
M4S2Y2,5615,153,23,60594,25.73,6,61.40,14
M4S1V3,5616,153,36,60630,25.73,9,61.40,22
M4S1X7,5617,153,44,60674,25.73,11,61.40,27
M4G3C4,5618,153,21,60695,25.73,5,61.40,13
M4S1X5,5619,153,8,60703,25.73,2,61.40,5
M9B4T1,5620,153,25,60728,28.12,7,51.03,13
M6S3M3,5621,153,3,60731,26.75,1,56.96,2
M4K2W4,5622,153,9,60740,25.92,2,60.53,5
M6C2V1,5623,153,58,60798,24.26,14,67.72,39
M4K2W8,5624,153,10,60808,25.92,3,60.53,6
L4L8E9,5625,153,30,60838,28.34,9,50.04,15
M4K1X8,5626,153,37,60875,23.70,9,70.14,26
M4K1G6,5627,153,20,60895,25.92,5,60.52,12
M4K1H5,5628,153,9,60904,25.92,2,60.52,5
M4K1K2,5629,153,18,60922,25.92,5,60.52,11
M4K2Y6,5630,153,25,60947,25.92,6,60.52,15
M4K1H4,5631,153,19,60966,25.92,5,60.51,11
M9P0A2,5632,153,1,60967,28.55,0,49.12,0
M4K2W6,5633,153,7,60974,25.92,2,60.51,4
M6S3H1,5634,153,49,61023,26.75,13,56.89,28
L4L2S2,5635,153,29,61052,27.40,8,54.07,16
L3T4J8,5636,153,22,61074,27.25,6,54.68,12
L3T4M5,5637,153,6,61080,27.25,2,54.68,3
L3T4M8,5638,153,7,61087,27.25,2,54.68,4
L3T4K1,5639,153,14,61101,27.25,4,54.68,8
L3T4M1,5640,153,32,61133,27.25,9,54.68,17
M6S1Y8,5641,153,3,61136,26.99,1,55.80,2
M6S1Y6,5642,153,2,61138,26.99,1,55.79,1
M6S1V4,5643,153,11,61149,26.99,3,55.78,6
M6S3L9,5644,153,38,61187,26.99,10,55.77,21
M6S3L8,5645,153,34,61221,26.99,9,55.77,19
M6S3G4,5646,153,39,61260,26.99,11,55.77,22
M6S3G3,5647,153,44,61304,26.99,12,55.77,25
M6S3L5,5648,153,41,61345,26.99,11,55.77,23
M6S1V3,5649,153,13,61358,26.99,4,55.77,7
M6S1V5,5650,153,7,61365,26.99,2,55.77,4
L4L5E6,5651,153,17,61382,27.54,5,53.37,9
L4L5E5,5652,153,11,61393,27.54,3,53.37,6
L4L5E9,5653,153,19,61412,27.54,5,53.37,10
L4L3X5,5654,153,39,61451,27.54,11,53.37,21
L4L5E8,5655,153,17,61468,27.54,5,53.37,9
L4L3V6,5656,153,53,61521,27.54,15,53.37,28
L4L5E4,5657,153,10,61531,27.54,3,53.37,5
L4L4B7,5658,153,21,61552,27.54,6,53.37,11
L4J8N4,5659,153,24,61576,27.49,7,53.58,13
M4W3V9,5660,153,1,61577,23.19,0,72.21,1
L4L5E7,5661,153,9,61586,27.54,2,53.36,5
L4L3W4,5662,153,3,61589,27.54,1,53.35,2
M3B2Y3,5663,153,5,61594,26.29,1,58.75,3
M3B1G1,5664,153,6,61600,26.29,2,58.74,4
M3B1K3,5665,153,8,61608,26.29,2,58.74,5
M4W1W2,5666,153,10,61618,23.19,2,72.17,7
M4W1Y8,5667,153,12,61630,23.19,3,72.17,9
M4W1Y9,5668,153,11,61641,23.19,3,72.17,8
M4W1V5,5669,153,14,61655,23.19,3,72.17,10
M4W1W6,5670,153,12,61667,23.19,3,72.17,9
M4W2S1,5671,153,4,61671,23.19,1,72.17,3
M4W1V6,5672,153,6,61677,23.19,1,72.17,4
M3B2Y6,5673,153,10,61687,26.29,3,58.74,6
M4W3W5,5674,153,21,61708,23.19,5,72.17,15
M3B2Z6,5675,153,9,61717,26.29,2,58.74,5
M4W2R4,5676,153,8,61725,23.19,2,72.17,6
M4W1Z8,5677,153,8,61733,23.19,2,72.16,6
M6G2X6,5678,153,1,61734,25.01,0,64.28,1
M4W1W7,5679,153,17,61751,23.19,4,72.16,12
M3B1L2,5680,153,7,61758,26.29,2,58.73,4
M3B2W5,5681,153,6,61764,26.29,2,58.73,4
M4W1V8,5682,153,7,61771,23.19,2,72.16,5
M4W2R9,5683,153,1,61772,23.19,0,72.16,1
L3T5N6,5684,153,15,61787,25.73,4,61.16,9
M4W3W4,5685,153,19,61806,23.19,4,72.16,14
M4W1S9,5686,153,13,61819,23.19,3,72.16,9
M3B2Z5,5687,153,7,61826,26.29,2,58.73,4
M3B1M4,5688,153,9,61835,26.29,2,58.73,5
M3B2Y2,5689,153,30,61865,26.29,8,58.73,18
M4W2R2,5690,153,4,61869,23.19,1,72.16,3
M3B1R4,5691,153,4,61873,26.29,1,58.73,2
M3B2Z9,5692,153,7,61880,26.29,2,58.73,4
M3B1K9,5693,153,7,61887,26.29,2,58.73,4
M4W2R5,5694,153,4,61891,23.19,1,72.16,3
M3B2Z2,5695,153,31,61922,26.29,8,58.73,18
M3B1M3,5696,153,9,61931,26.29,2,58.73,5
M4W2R3,5697,153,8,61939,23.19,2,72.16,6
M3B1L1,5698,153,12,61951,26.29,3,58.72,7
M3B1C3,5699,153,10,61961,26.29,3,58.72,6
M3B1K4,5700,153,4,61965,26.29,1,58.72,2
M3B2Y5,5701,153,7,61972,26.29,2,58.71,4
M5R0A6,5702,153,1,61973,27.38,0,53.99,1
M4W1W1,5703,153,2,61975,23.19,0,72.14,1
M6G2B3,5704,153,9,61984,25.01,2,64.25,6
M6G2E7,5705,153,37,62021,25.01,9,64.25,24
M6G2M8,5706,153,33,62054,25.01,8,64.25,21
M6G2M9,5707,153,37,62091,25.01,9,64.25,24
M9B1W8,5708,153,1,62092,28.46,0,49.26,0
M5R1N7,5709,153,12,62104,22.23,3,76.25,9
L4J1K5,5710,153,11,62115,26.17,3,59.17,7
M5P3C9,5711,153,4,62119,23.56,1,70.47,3
M5P1V8,5712,153,2,62121,23.56,0,70.47,1
M5P3E9,5713,153,9,62130,23.56,2,70.46,6
M5P3G1,5714,153,5,62135,23.56,1,70.46,4
M5P1V2,5715,153,10,62145,23.56,2,70.46,7
M5P1T1,5716,153,4,62149,23.56,1,70.46,3
M5P3B9,5717,153,12,62161,23.56,3,70.46,8
M5P3C1,5718,153,10,62171,23.56,2,70.45,7
M5P3C2,5719,153,10,62181,23.56,2,70.45,7
M5P1T9,5720,153,4,62185,23.56,1,70.45,3
M5P3C4,5721,153,11,62196,23.56,3,70.45,8
M5P2Z9,5722,153,11,62207,23.56,3,70.45,8
M6K3M6,5723,153,36,62243,28.12,10,50.69,18
M5P1V6,5724,153,1,62244,23.56,0,70.43,1
M5P1W8,5725,153,3,62247,23.55,1,70.47,2
M6B0A1,5726,153,1,62248,26.50,0,57.68,1
M5P3M5,5727,153,1,62249,23.56,0,70.42,1
M5P1V7,5728,153,1,62250,23.56,0,70.42,1
M5P2Z5,5729,153,13,62263,23.55,3,70.46,9
M5P2Z7,5730,153,9,62272,23.55,2,70.45,6
M4A1V3,5731,153,3,62275,24.56,1,66.06,2
M4A2H1,5732,153,10,62285,24.56,2,66.06,7
M4A1V4,5733,153,12,62297,24.56,3,66.06,8
M4A2J8,5734,153,23,62320,24.56,6,66.06,15
M4A2J7,5735,153,33,62353,24.56,8,66.06,22
L3T5S6,5736,153,18,62371,25.73,5,60.99,11
L3T5R7,5737,153,6,62377,25.73,2,60.98,4
M6C1M8,5738,153,15,62392,28.19,4,50.32,8
M4A1V5,5739,153,11,62403,24.56,3,66.05,7
M4V1Y9,5740,153,44,62447,26.54,12,57.47,25
M4V2A3,5741,153,7,62454,26.54,2,57.47,4
M4A2G8,5742,153,5,62459,24.56,1,66.04,3
M4V2C9,5743,153,5,62464,26.54,1,57.46,3
M6K3M3,5744,153,13,62477,28.12,4,50.62,7
M4Y2L4,5745,153,17,62494,28.15,5,50.48,9
M4Y2N6,5746,153,19,62513,28.15,5,50.48,10
M4Y2L8,5747,153,9,62522,28.15,3,50.48,5
M4Y2N7,5748,153,18,62540,28.15,5,50.47,9
M4G0A4,5749,153,8,62548,21.15,2,80.79,6
L3T5J7,5750,153,17,62565,25.72,4,60.98,10
L3T5S5,5751,153,25,62590,25.72,6,60.98,15
M2N2K9,5752,153,7,62597,26.94,2,55.69,4
M4V1Y1,5753,153,49,62646,26.53,13,57.47,28
M4N1Y5,5754,153,22,62668,26.08,6,59.42,13
L3T5R6,5755,153,7,62675,25.72,2,60.97,4
M3A3H3,5756,153,26,62701,25.08,7,63.74,17
M3A3L6,5757,153,3,62704,25.08,1,63.73,2
M6C1N8,5758,153,4,62708,28.17,1,50.34,2
M6C1P1,5759,153,2,62710,28.17,1,50.32,1
M4N2V7,5760,153,1,62711,26.06,0,59.46,1
M6C2A2,5761,153,9,62720,28.17,3,50.32,5
M2R3R6,5762,153,19,62739,24.43,5,66.52,13
M2R3R7,5763,153,14,62753,24.43,3,66.52,9
M2R3S7,5764,153,24,62777,24.43,6,66.52,16
M2R3V6,5765,153,22,62799,24.43,5,66.52,15
M6C3A5,5766,153,32,62831,28.17,9,50.32,16
M6C1W9,5767,153,9,62840,28.17,3,50.31,5
M2R3R8,5768,153,37,62877,24.43,9,66.52,25
M6C2A1,5769,153,8,62885,28.17,2,50.31,4
M2R3S1,5770,153,17,62902,24.43,4,66.51,11
M2R3T3,5771,153,9,62911,24.43,2,66.51,6
M6C1X1,5772,153,8,62919,28.17,2,50.31,4
M6C3M5,5773,153,7,62926,28.17,2,50.31,4
M6C3K8,5774,153,10,62936,28.17,3,50.31,5
M6C3M6,5775,153,8,62944,28.17,2,50.30,4
M6C3M3,5776,153,3,62947,28.17,1,50.30,2
M5N2S8,5777,153,1,62948,25.60,0,61.43,1
L4J6L7,5778,153,10,62958,28.07,3,50.72,5
M2N2R1,5779,153,5,62963,26.10,1,59.24,3
M2N2B7,5780,153,16,62979,26.10,4,59.24,9
L4J6L4,5781,153,10,62989,28.07,3,50.70,5
L4J6L1,5782,153,10,62999,28.07,3,50.70,5
M2N2A6,5783,153,13,63012,26.10,3,59.24,8
M2N2P8,5784,153,6,63018,26.10,2,59.24,4
M2N2A4,5785,153,10,63028,26.10,3,59.24,6
L4J6L3,5786,153,15,63043,28.07,4,50.70,8
L4J6K7,5787,153,10,63053,28.07,3,50.70,5
M2N2A5,5788,153,16,63069,26.10,4,59.23,9
L4J6M5,5789,153,15,63084,28.07,4,50.70,8
M2N1Z4,5790,153,10,63094,26.10,3,59.23,6
M2N2B5,5791,153,14,63108,26.10,4,59.23,8
M6C1N1,5792,153,8,63116,28.20,2,50.13,4
L4J6L5,5793,153,15,63131,28.07,4,50.69,8
L4J6L2,5794,153,11,63142,28.07,3,50.69,6
M9B4N8,5795,153,22,63164,27.96,6,51.17,11
M5N1V9,5796,153,6,63170,25.60,2,61.37,4
M5N1X4,5797,153,8,63178,25.60,2,61.36,5
M5N1W8,5798,153,7,63185,25.60,2,61.36,4
M5N2T2,5799,153,3,63188,25.60,1,61.35,2
M3A3E2,5800,153,3,63191,25.32,1,62.55,2
M3A3G5,5801,153,12,63203,25.32,3,62.55,8
M3A2Z1,5802,153,11,63214,25.32,3,62.55,7
M3A3C8,5803,153,4,63218,25.32,1,62.55,3
M3A3G1,5804,153,9,63227,25.32,2,62.55,6
M3A3G6,5805,153,18,63245,25.32,5,62.55,11
M3A3B9,5806,153,40,63285,25.32,10,62.55,25
M5N1V7,5807,153,3,63288,25.59,1,61.38,2
M3A2Z6,5808,152,4,63292,25.32,1,62.55,3
M3A2Z5,5809,152,4,63296,25.32,1,62.55,3
M5P1K1,5810,152,4,63300,27.75,1,52.02,2
M3A3C9,5811,152,11,63311,25.32,3,62.55,7
M3A2Z2,5812,152,6,63317,25.32,2,62.54,4
M3A3G3,5813,152,10,63327,25.32,3,62.54,6
M3A3E1,5814,152,5,63332,25.32,1,62.54,3
M5N1X3,5815,152,3,63335,25.59,1,61.37,2
M9C4B7,5816,152,1,63336,30.29,0,41.01,0
M5N2S5,5817,152,8,63344,25.59,2,61.37,5
M3A3H1,5818,152,4,63348,25.32,1,62.54,3
M3A3G2,5819,152,5,63353,25.32,1,62.54,3
M5N2V8,5820,152,10,63363,25.59,3,61.36,6
M5P1K3,5821,152,5,63368,27.75,1,52.01,3
M5N2V9,5822,152,8,63376,25.59,2,61.36,5
M5N1V5,5823,152,9,63385,25.59,2,61.36,6
M8Z3Y3,5824,152,3,63388,26.18,1,58.80,2
M5P2M2,5825,152,11,63399,27.75,3,52.00,6
M5P2M7,5826,152,15,63414,27.75,4,52.00,8
M3A2Z7,5827,152,4,63418,25.32,1,62.52,3
M5P2M4,5828,152,22,63440,27.75,6,52.00,11
M5P2M6,5829,152,12,63452,27.75,3,51.99,6
M5P2M3,5830,152,10,63462,27.75,3,51.99,5
M5P2M8,5831,152,14,63476,27.75,4,51.99,7
M5P1B6,5832,152,2,63478,27.75,1,51.99,1
M5N2V7,5833,152,2,63480,25.59,1,61.35,1
M5P1B8,5834,152,4,63484,27.75,1,51.98,2
M8Z3J4,5835,152,2,63486,27.64,1,52.45,1
M8Y2P4,5836,152,3,63489,27.64,1,52.45,2
M8Z3E5,5837,152,2,63491,27.64,1,52.45,1
M8Z3E7,5838,152,4,63495,27.64,1,52.44,2
M8Z3M9,5839,152,14,63509,27.64,4,52.44,7
M8Y2V5,5840,152,14,63523,27.64,4,52.43,7
L3T5P3,5841,152,6,63529,25.91,2,59.93,4
M8Y2V7,5842,152,13,63542,27.64,4,52.43,7
M8Z3T5,5843,152,11,63553,27.64,3,52.43,6
M8Z3N1,5844,152,12,63565,27.64,3,52.43,6
M8Y3P4,5845,152,16,63581,27.64,4,52.43,8
M8Y2V8,5846,152,13,63594,27.64,4,52.43,7
M8Y2V6,5847,152,12,63606,27.64,3,52.43,6
M8Z3N2,5848,152,18,63624,27.64,5,52.43,9
M8Z3M8,5849,152,13,63637,27.64,4,52.43,7
L3T5L6,5850,152,15,63652,25.70,4,60.83,9
M8Z3T2,5851,152,15,63667,27.64,4,52.43,8
M8Z3T4,5852,152,13,63680,27.64,4,52.43,7
M8Y3P2,5853,152,13,63693,27.64,4,52.43,7
M5P1B7,5854,152,1,63694,27.75,0,51.95,1
M8Z3N4,5855,152,12,63706,27.64,3,52.43,6
M8Z3M7,5856,152,16,63722,27.64,4,52.42,8
M8Z3T3,5857,152,10,63732,27.64,3,52.42,5
M8Z3N3,5858,152,15,63747,27.64,4,52.42,8
M8Z3N5,5859,152,12,63759,27.64,3,52.42,6
M2L2H5,5860,152,6,63765,22.88,1,73.04,4
M8Z5V1,5861,152,1,63766,27.64,0,52.41,1
M2L2J5,5862,152,6,63772,22.88,1,73.04,4
M8X1Z3,5863,152,9,63781,27.64,2,52.41,5
M9C4M3,5864,152,8,63789,30.29,2,40.93,3
M2L1B9,5865,152,14,63803,22.88,3,73.03,10
M2N3E6,5866,152,15,63818,22.83,3,73.25,11
M2L2G9,5867,152,12,63830,22.88,3,73.03,9
M2L2H7,5868,152,13,63843,22.88,3,73.03,9
M2L2H6,5869,152,5,63848,22.88,1,73.03,4
M2L2H3,5870,152,17,63865,22.88,4,73.03,12
M2L2G4,5871,152,15,63880,22.88,3,73.03,11
M8Z3J3,5872,152,2,63882,27.64,1,52.40,1
M8Z3E6,5873,152,3,63885,27.64,1,52.40,2
M8Y2M7,5874,152,2,63887,27.64,1,52.40,1
M2L2H1,5875,152,3,63890,22.88,1,73.03,2
M2L2H4,5876,152,11,63901,22.88,3,73.02,8
M2L2G7,5877,152,7,63908,22.88,2,73.02,5
M2L2H2,5878,152,2,63910,22.88,0,73.02,1
M2L2J6,5879,152,3,63913,22.88,1,73.01,2
M5R3A8,5880,152,14,63927,24.54,3,65.79,9
M2K1N3,5881,152,4,63931,24.72,1,65.01,3
M2K1T4,5882,152,3,63934,24.72,1,65.00,2
M2K1N1,5883,152,8,63942,24.72,2,65.00,5
M8Z4H8,5884,152,1,63943,27.00,0,55.12,1
M4V1G5,5885,152,6,63949,24.32,1,66.73,4
M8Z3V6,5886,152,4,63953,27.00,1,55.11,2
M2K1X6,5887,152,7,63960,24.72,2,64.99,5
M2K1Z4,5888,152,23,63983,24.72,6,64.99,15
M2K2V3,5889,152,9,63992,24.72,2,64.99,6
M2K1X5,5890,152,10,64002,24.72,2,64.99,6
M2K1R2,5891,152,8,64010,24.72,2,64.99,5
M8Z3P7,5892,152,2,64012,27.00,1,55.11,1
M2K1V4,5893,152,15,64027,24.72,4,64.99,10
M2K2V6,5894,152,24,64051,24.72,6,64.99,16
M2K1V3,5895,152,10,64061,24.72,2,64.99,6
M2K1T3,5896,152,15,64076,24.72,4,64.99,10
M2K2W4,5897,152,27,64103,24.72,7,64.99,18
M2K1K5,5898,152,10,64113,24.72,2,64.99,6
M8Z3W9,5899,152,2,64115,27.00,1,55.11,1
M2K1M1,5900,152,12,64127,24.72,3,64.99,8
M2K2V2,5901,152,29,64156,24.72,7,64.98,19
M2K1L9,5902,152,10,64166,24.72,2,64.98,6
M2K1X4,5903,152,11,64177,24.72,3,64.98,7
M2K1X3,5904,152,28,64205,24.72,7,64.98,18
M2K1N6,5905,152,14,64219,24.72,3,64.98,9
M8Z3B6,5906,152,4,64223,27.00,1,55.10,2
M8Z2Z1,5907,152,8,64231,27.00,2,55.10,4
M8Z3A2,5908,152,11,64242,27.00,3,55.10,6
M8Z2W4,5909,152,17,64259,27.00,5,55.10,9
M2K1T6,5910,152,3,64262,24.72,1,64.98,2
M2K2W9,5911,152,7,64269,24.72,2,64.98,5
M8Z3W7,5912,152,1,64270,27.00,0,55.10,1
M8Z4K4,5913,152,2,64272,27.00,1,55.10,1
M2K1S1,5914,152,3,64275,24.72,1,64.98,2
M8Z3B8,5915,152,5,64280,27.00,1,55.10,3
M8Z3A1,5916,152,11,64291,27.00,3,55.10,6
M2K1R9,5917,152,3,64294,24.72,1,64.97,2
M8Z3B9,5918,152,4,64298,27.00,1,55.09,2
M2K1K6,5919,152,4,64302,24.72,1,64.97,3
M8Z4J3,5920,152,7,64309,27.00,2,55.09,4
M2K1T7,5921,152,6,64315,24.72,1,64.97,4
M8Z3G6,5922,152,8,64323,27.00,2,55.09,4
M8Z2X8,5923,152,4,64327,27.00,1,55.09,2
M8Z3G4,5924,152,7,64334,27.00,2,55.09,4
M8Z3G2,5925,152,9,64343,27.00,2,55.09,5
M8Z4J1,5926,152,7,64350,27.00,2,55.09,4
M8Z3W6,5927,152,1,64351,27.00,0,55.09,1
M3H2H7,5928,152,6,64357,26.47,2,57.36,3
M3H2H3,5929,152,3,64360,26.47,1,57.36,2
M3H2H4,5930,152,11,64371,26.47,3,57.35,6
M3H2E2,5931,152,5,64376,26.47,1,57.35,3
M3H2E3,5932,152,3,64379,26.47,1,57.35,2
M3H2E1,5933,152,7,64386,26.47,2,57.35,4
M3H2K1,5934,152,15,64401,26.47,4,57.35,9
M3H2E5,5935,152,7,64408,26.47,2,57.35,4
M3H3J4,5936,152,6,64414,26.47,2,57.35,3
L4L6X6,5937,152,11,64425,27.12,3,54.53,6
M3H3H9,5938,152,9,64434,26.47,2,57.35,5
L4L6X5,5939,152,11,64445,27.12,3,54.53,6
L4L6X3,5940,152,14,64459,27.12,4,54.53,8
M3H3J2,5941,152,6,64465,26.47,2,57.35,3
L4L6X2,5942,152,18,64483,27.12,5,54.53,10
M3H2J5,5943,152,13,64496,26.47,3,57.35,7
M3H3H8,5944,152,8,64504,26.47,2,57.34,5
M3H3H7,5945,152,6,64510,26.47,2,57.34,3
M3H3H4,5946,152,8,64518,26.47,2,57.34,5
M3H2G8,5947,152,7,64525,26.47,2,57.34,4
M2K1N5,5948,152,1,64526,24.72,0,64.92,1
M3H3J5,5949,152,3,64529,26.47,1,57.33,2
M3H3L4,5950,152,4,64533,26.47,1,57.33,2
M6S3M5,5951,152,60,64593,26.70,16,56.32,34
L4L0C9,5952,152,12,64605,27.38,3,53.37,6
M3H3H6,5953,152,2,64607,26.47,1,57.31,1
M8Z3V8,5954,152,2,64609,26.97,1,55.12,1
M8Z4H9,5955,152,1,64610,27.00,0,54.99,1
L4L0E1,5956,152,15,64625,27.37,4,53.37,8
L3T5W7,5957,152,11,64636,24.66,3,65.09,7
M5M3W5,5958,152,6,64642,26.94,2,55.19,3
M8Z2Y5,5959,152,1,64643,26.96,0,55.09,1
L4L7S8,5960,152,11,64654,26.49,3,57.13,6
M5M2R6,5961,152,9,64663,26.94,2,55.18,5
M5M2M5,5962,152,16,64679,26.94,4,55.17,9
M6B1T2,5963,152,13,64692,27.92,4,50.92,7
M5M2K6,5964,152,14,64706,26.94,4,55.17,8
M5M2M6,5965,152,14,64720,26.94,4,55.17,8
M5M2P2,5966,152,12,64732,26.94,3,55.17,7
M5M2K7,5967,152,19,64751,26.94,5,55.17,10
M5M3W7,5968,152,7,64758,26.94,2,55.16,4
M5M2P3,5969,152,11,64769,26.94,3,55.16,6
M4K1W5,5970,152,36,64805,22.46,8,74.55,27
M4G3P6,5971,152,4,64809,28.05,1,50.34,2
M3B2N3,5972,152,9,64818,25.82,2,60.00,5
M5M3W2,5973,152,5,64823,26.94,1,55.14,3
M4G2R2,5974,152,3,64826,28.05,1,50.32,2
M5R1Z4,5975,152,10,64836,24.53,2,65.57,7
M4G2M1,5976,152,10,64846,28.05,3,50.31,5
M4G2M2,5977,152,13,64859,28.05,4,50.30,7
M4G3L1,5978,152,10,64869,28.05,3,50.30,5
M4G2N6,5979,152,6,64875,28.05,2,50.30,3
M4G2K4,5980,152,3,64878,28.05,1,50.30,2
M4G2N7,5981,152,17,64895,28.05,5,50.30,9
M4G3K9,5982,152,14,64909,28.05,4,50.30,7
M2P1B4,5983,152,1,64910,25.12,0,62.99,1
M4G3E1,5984,152,6,64916,28.05,2,50.30,3
M4G3K7,5985,152,9,64925,28.05,3,50.29,5
M4G2N8,5986,152,2,64927,28.05,1,50.29,1
M4G3K8,5987,152,6,64933,28.05,2,50.29,3
M9A2Y5,5988,152,2,64935,28.11,1,50.03,1
M6S2K9,5989,152,12,64947,26.70,3,56.13,7
M9A2Y9,5990,152,2,64949,28.11,1,50.02,1
M9B4A2,5991,152,3,64952,28.07,1,50.19,2
M6P2Z8,5992,152,54,65006,24.56,13,65.39,35
M9A5A5,5993,152,13,65019,28.11,4,50.00,7
M9A5A4,5994,152,27,65046,28.11,8,50.00,14
M9A3B6,5995,152,2,65048,28.11,1,50.00,1
M9A2X7,5996,152,1,65049,28.11,0,50.00,1
M2R3C4,5997,152,1,65050,24.31,0,66.46,1
M9A3A6,5998,152,11,65061,28.11,3,50.00,6
M9A3A7,5999,152,5,65066,28.11,1,49.99,2
M2P1B7,6000,152,1,65067,25.12,0,62.94,1
M2P1H4,6001,152,5,65072,25.12,1,62.93,3
M2P1R4,6002,152,12,65084,25.12,3,62.93,8
M2P1P9,6003,152,11,65095,25.12,3,62.93,7
M2P1R7,6004,152,19,65114,25.12,5,62.93,12
M2P1H3,6005,152,8,65122,25.12,2,62.92,5
M2P1R6,6006,152,11,65133,25.12,3,62.92,7
M2P1R8,6007,152,15,65148,25.12,4,62.92,9
M2P2G3,6008,152,11,65159,25.12,3,62.92,7
M9A5B2,6009,152,1,65160,28.11,0,49.96,0
M6P2Z9,6010,152,47,65207,24.54,12,65.40,31
M5M1A2,6011,152,2,65209,25.04,1,63.22,1
M3B1N3,6012,152,2,65211,27.41,1,52.95,1
M6S3S1,6013,152,35,65246,26.69,9,56.07,20
M3B2C5,6014,152,13,65259,27.41,4,52.95,7
M9B4A1,6015,152,1,65260,28.07,0,50.09,1
M3B1R1,6016,152,8,65268,27.41,2,52.95,4
M3B1R5,6017,152,13,65281,27.41,4,52.95,7
M5M1A5,6018,152,5,65286,25.04,1,63.21,3
M3B1P9,6019,152,10,65296,27.41,3,52.94,5
M3B2C9,6020,152,5,65301,27.41,1,52.94,3
M5M1A4,6021,152,8,65309,25.04,2,63.21,5
M5M3J5,6022,152,28,65337,25.04,7,63.21,18
M5M3C5,6023,152,27,65364,25.04,7,63.20,17
M5M3C4,6024,152,29,65393,25.04,7,63.20,18
M5M3C2,6025,152,28,65421,25.04,7,63.20,18
M8X0A4,6026,152,16,65437,24.16,4,67.01,11
M3B1N1,6027,152,2,65439,27.41,1,52.93,1
M9A3W1,6028,152,16,65455,28.05,4,50.15,8
M9C5B6,6029,152,42,65497,25.48,11,61.27,26
M3B1N2,6030,152,5,65502,27.40,1,52.95,3
M3B2E8,6031,152,6,65508,27.40,2,52.95,3
M3B1N6,6032,152,24,65532,27.40,7,52.95,13
M3B2C7,6033,152,13,65545,27.40,4,52.95,7
M3B2L6,6034,152,10,65555,27.40,3,52.95,5
M4K1S3,6035,152,1,65556,25.45,0,61.39,1
M3B1P8,6036,152,13,65569,27.40,4,52.94,7
M3B2C6,6037,152,9,65578,27.40,2,52.94,5
L4J7T4,6038,152,38,65616,27.38,10,53.02,20
M4K2V5,6039,152,6,65622,25.45,2,61.37,4
M4K2W3,6040,152,7,65629,25.45,2,61.36,4
M4K1S5,6041,152,8,65637,25.45,2,61.36,5
M4K1R6,6042,152,9,65646,25.45,2,61.36,6
M4K2W1,6043,152,21,65667,25.45,5,61.36,13
M4K2V2,6044,152,23,65690,25.45,6,61.36,14
M4K2V6,6045,152,3,65693,25.45,1,61.36,2
M4K1S2,6046,152,7,65700,25.45,2,61.36,4
M4K2V4,6047,152,15,65715,25.45,4,61.35,9
M4K2X6,6048,152,20,65735,25.45,5,61.35,12
M4K2W2,6049,152,14,65749,25.45,4,61.35,9
M4K1T6,6050,152,5,65754,25.45,1,61.35,3
M6K3M5,6051,152,47,65801,27.91,13,50.69,24
L4J6P9,6052,152,7,65808,27.90,2,50.73,4
L4J6R2,6053,152,9,65817,27.90,3,50.72,5
M3H2J4,6054,152,12,65829,26.37,3,57.35,7
L3T5G8,6055,152,40,65869,25.85,10,59.59,24
M4X1B3,6056,152,27,65896,23.49,6,69.81,19
M6S1Z6,6057,152,45,65941,27.51,12,52.39,24
M6S1Z7,6058,152,42,65983,27.51,12,52.39,22
M6S1Y1,6059,152,43,66026,27.51,12,52.39,23
M2K1S7,6060,152,10,66036,24.29,2,66.32,7
L3T5A9,6061,152,34,66070,25.85,9,59.55,20
L3T5P1,6062,152,3,66073,25.85,1,59.55,2
L3T1C1,6063,152,10,66083,25.86,3,59.50,6
M4S1W7,6064,152,17,66100,25.94,4,59.15,10
M9R2W7,6065,152,6,66106,27.89,2,50.70,3
M9R2W9,6066,152,6,66112,27.89,2,50.69,3
M9R2X7,6067,152,9,66121,27.89,3,50.69,5
M9R2X6,6068,152,7,66128,27.89,2,50.69,4
M6B1Z8,6069,152,16,66144,25.57,4,60.74,10
M6S1T7,6070,152,10,66154,28.02,3,50.12,5
M6P3A1,6071,152,5,66159,26.91,1,54.92,3
M6S1S6,6072,152,7,66166,28.02,2,50.11,4
M6S3X5,6073,152,42,66208,28.02,12,50.11,21
M6S1T6,6074,152,15,66223,28.02,4,50.11,8
M6S1V8,6075,152,10,66233,28.02,3,50.11,5
M6S3X6,6076,152,5,66238,28.02,1,50.11,3
M5N2L5,6077,152,2,66240,27.66,1,51.67,1
M6S1W1,6078,152,12,66252,28.02,3,50.11,6
M6S1S7,6079,152,18,66270,28.02,5,50.11,9
M4S1T2,6080,152,11,66281,26.21,3,57.94,6
M4S1T1,6081,152,9,66290,26.21,2,57.94,5
M6P1L9,6082,152,30,66320,26.90,8,54.94,16
M6P3C6,6083,152,33,66353,26.90,9,54.94,18
M6P3C7,6084,152,25,66378,26.90,7,54.94,14
M6S2Y9,6085,152,7,66385,26.90,2,54.94,4
M5N1H1,6086,152,15,66400,27.66,4,51.64,8
M6P3E2,6087,152,19,66419,26.90,5,54.94,10
M5N1J8,6088,152,58,66477,27.66,16,51.64,30
M5N1J9,6089,152,21,66498,27.66,6,51.64,11
M5N2J9,6090,152,5,66503,27.66,1,51.64,3
M5N1L4,6091,152,64,66567,27.66,18,51.64,33
M6S2Y2,6092,152,42,66609,26.46,11,56.84,24
M5P2L6,6093,152,15,66624,24.79,4,64.07,10
L4J8X9,6094,152,1,66625,28.12,0,49.64,0
M4S1N5,6095,152,6,66631,26.20,2,57.95,3
M4S1T3,6096,152,6,66637,26.20,2,57.95,3
M6S2X4,6097,152,29,66666,24.60,7,64.88,19
M4S2Y1,6098,152,20,66686,26.20,5,57.94,12
M4S2X9,6099,152,18,66704,26.20,5,57.94,10
M4S1V4,6100,152,33,66737,26.20,9,57.94,19
M4S2X4,6101,152,18,66755,26.20,5,57.94,10
M4V1Y2,6102,152,46,66801,26.31,12,57.47,26
M4S1N4,6103,152,11,66812,26.20,3,57.94,6
M6S2B1,6104,152,46,66858,27.48,13,52.39,24
M9B4N7,6105,152,6,66864,27.76,2,51.17,3
M4K2W9,6106,152,2,66866,25.59,1,60.56,1
L4J5K3,6107,152,15,66881,27.94,4,50.37,8
L4J5J5,6108,152,8,66889,27.94,2,50.37,4
L4J7C5,6109,152,18,66907,24.76,4,64.14,12
M4K1J3,6110,152,26,66933,25.59,7,60.52,16
L3T2V2,6111,152,16,66949,24.53,4,65.09,10
M4V1G3,6112,152,53,67002,24.15,13,66.73,35
M2P1N1,6113,152,15,67017,25.05,4,62.82,9
M2P1M9,6114,152,14,67031,25.05,4,62.82,9
M2P1M6,6115,152,22,67053,25.05,6,62.82,14
M2L2V9,6116,152,9,67062,24.81,2,63.85,6
M2L2W6,6117,152,10,67072,24.81,2,63.84,6
M2L2W5,6118,152,21,67093,24.81,5,63.84,13
M2L2W3,6119,152,33,67126,24.81,8,63.84,21
M2L2V6,6120,152,28,67154,24.81,7,63.84,18
M2L2V8,6121,152,15,67169,24.81,4,63.84,10
M3B3R8,6122,152,11,67180,25.30,3,61.71,7
M2L2V7,6123,152,1,67181,24.81,0,63.83,1
M2P1L3,6124,152,1,67182,25.05,0,62.79,1
M5R2L4,6125,152,37,67219,23.53,9,69.35,26
M6H3H1,6126,152,26,67245,22.23,6,74.97,19
L3T4N2,6127,152,9,67254,26.91,2,54.69,5
L3T4L8,6128,152,23,67277,26.91,6,54.68,13
L3T4N1,6129,152,32,67309,26.91,9,54.68,17
L3T4J9,6130,152,16,67325,26.91,4,54.68,9
L3T4M7,6131,152,25,67350,26.91,7,54.68,14
L3T4K2,6132,152,8,67358,26.91,2,54.68,4
M6P3G5,6133,152,44,67402,24.67,11,64.35,28
M9C5E4,6134,152,13,67415,25.50,3,60.74,8
M9C5C7,6135,152,8,67423,25.50,2,60.74,5
M4K1C8,6136,152,68,67491,25.98,18,58.65,40
M9A5A2,6137,152,19,67510,27.81,5,50.71,10
M5V1C2,6138,152,11,67521,23.90,3,67.64,7
M9A4Z1,6139,152,32,67553,27.81,9,50.70,16
M9A4Z4,6140,152,49,67602,27.81,14,50.70,25
M9A4Z2,6141,152,17,67619,27.81,5,50.70,9
M3B1C4,6142,152,7,67626,25.95,2,58.75,4
M9A5A6,6143,152,3,67629,27.81,1,50.69,2
M2J1G8,6144,152,11,67640,26.37,3,56.93,6
M2K1Z6,6145,152,2,67642,24.52,0,64.93,1
M2J1H1,6146,152,8,67650,26.37,2,56.92,5
M3B3A4,6147,152,24,67674,25.95,6,58.73,14
M3B2Z1,6148,152,13,67687,25.95,3,58.73,8
M3B2Z3,6149,152,14,67701,25.95,4,58.73,8
M3B1L7,6150,152,9,67710,27.84,3,50.54,5
M3B2Y9,6151,152,19,67729,25.95,5,58.73,11
M3B2Z8,6152,152,7,67736,25.95,2,58.73,4
M3B1M8,6153,152,7,67743,27.84,2,50.53,4
M2K2B5,6154,152,5,67748,24.52,1,64.91,3
M2K2A5,6155,152,16,67764,24.52,4,64.91,10
M2K2A6,6156,152,8,67772,24.52,2,64.91,5
M2K2B6,6157,152,6,67778,24.52,1,64.91,4
M2K1Z5,6158,152,3,67781,24.52,1,64.91,2
M2K2B8,6159,152,12,67793,24.52,3,64.91,8
M2K2A2,6160,152,9,67802,24.52,2,64.91,6
M2K2A7,6161,152,25,67827,24.52,6,64.91,16
M2K1Z3,6162,152,6,67833,24.52,1,64.90,4
M2K1Z9,6163,152,5,67838,24.52,1,64.90,3
M2K2A1,6164,152,15,67853,24.52,4,64.90,10
M2K2B1,6165,152,11,67864,24.52,3,64.90,7
M2K1Z7,6166,152,12,67876,24.52,3,64.90,8
L4L2Y6,6167,152,9,67885,28.10,3,49.39,4
M2K2A9,6168,152,14,67899,24.52,3,64.90,9
M2K2A8,6169,152,13,67912,24.52,3,64.90,8
M2K2B3,6170,152,12,67924,24.52,3,64.90,8
M2K2A3,6171,152,9,67933,24.52,2,64.90,6
M9B3Y4,6172,152,10,67943,27.31,3,52.81,5
M2K1Z8,6173,152,5,67948,24.52,1,64.89,3
L4L1N4,6174,152,41,67989,28.10,12,49.38,20
L3T6W5,6175,152,17,68006,25.59,4,60.25,10
L3T7J7,6176,151,16,68022,25.78,4,59.42,10
L4L1N5,6177,151,4,68026,27.88,1,50.31,2
L4L1N3,6178,151,22,68048,27.88,6,50.30,11
L4H0H7,6179,151,39,68087,27.94,11,50.03,20
M3B2X1,6180,151,1,68088,27.84,0,50.46,1
M8X2G9,6181,151,1,68089,27.59,0,51.53,1
L3T5P6,6182,151,3,68092,25.37,1,61.14,2
L4J6R1,6183,151,10,68102,27.83,3,50.48,5
L4J6R5,6184,151,11,68113,27.83,3,50.47,6
M5M3K3,6185,151,4,68117,27.36,1,52.51,2
L4L2Y3,6186,151,1,68118,28.10,0,49.30,0
M9C5E8,6187,151,43,68161,24.54,11,64.72,28
M9C5B8,6188,151,29,68190,24.54,7,64.72,19
M9C5B9,6189,151,16,68206,24.54,4,64.72,10
M9C5B7,6190,151,44,68250,24.54,11,64.72,28
M9C5B5,6191,151,28,68278,24.54,7,64.72,18
M9C5B4,6192,151,21,68299,24.54,5,64.72,14
M9C5B2,6193,151,11,68310,24.54,3,64.71,7
M9A3P1,6194,151,2,68312,27.59,1,51.49,1
M5M1S6,6195,151,31,68343,27.36,8,52.48,16
M5M1V9,6196,151,30,68373,27.36,8,52.48,16
M5P2Z2,6197,151,1,68374,26.45,0,56.42,1
M9A2T7,6198,151,5,68379,27.59,1,51.48,3
M5M1P3,6199,151,30,68409,27.36,8,52.48,16
M8X2Z9,6200,151,1,68410,27.36,0,52.48,1
M5P1S6,6201,151,1,68411,26.45,0,56.42,1
M5P1S8,6202,151,6,68417,26.45,2,56.42,3
M9A2W1,6203,151,9,68426,27.59,2,51.48,5
M9A2V6,6204,151,7,68433,27.59,2,51.47,4
M9A2V4,6205,151,25,68458,27.59,7,51.47,13
M6B1Z2,6206,151,7,68465,25.85,2,59.01,4
M5P1S9,6207,151,6,68471,26.45,2,56.41,3
M8X1P4,6208,151,14,68485,27.59,4,51.47,7
M9A2T8,6209,151,5,68490,27.59,1,51.47,3
M8X2A3,6210,151,31,68521,27.59,9,51.47,16
M5P1S3,6211,151,8,68529,26.45,2,56.40,5
M9A3N7,6212,151,42,68571,27.59,12,51.47,22
M8X2A1,6213,151,33,68604,27.59,9,51.47,17
M9C5G3,6214,151,1,68605,24.54,0,64.68,1
M8X1N1,6215,151,4,68609,27.59,1,51.46,2
M5P3B7,6216,151,5,68614,26.45,1,56.40,3
M5P1S5,6217,151,8,68622,26.45,2,56.40,5
M9A2V5,6218,151,11,68633,27.59,3,51.46,6
M4R1M5,6219,151,28,68661,22.73,6,72.51,20
M5P1S2,6220,151,7,68668,26.45,2,56.39,4
M6B1X2,6221,151,5,68673,25.85,1,58.99,3
M5P2Z3,6222,151,1,68674,26.45,0,56.39,1
M6B1X4,6223,151,14,68688,25.85,4,58.99,8
M9A2W2,6224,151,4,68692,27.59,1,51.45,2
M9A3N9,6225,151,2,68694,27.59,1,51.45,1
M9C5G4,6226,151,1,68695,24.54,0,64.64,1
M3A1N3,6227,151,12,68707,28.51,3,47.44,6
L4J5J8,6228,151,9,68716,27.95,3,49.86,4
M8X2A5,6229,151,7,68723,27.58,2,51.46,4
M3B1C9,6230,151,42,68765,27.80,12,50.49,21
M3B2T2,6231,151,43,68808,27.80,12,50.49,22
M3B1S7,6232,151,7,68815,25.03,2,62.47,4
M3B1V1,6233,151,8,68823,25.03,2,62.47,5
M3B1R3,6234,151,8,68831,25.03,2,62.47,5
M3B2N6,6235,151,6,68837,25.03,2,62.47,4
M3B2R1,6236,151,18,68855,25.03,5,62.47,11
M3B2P1,6237,151,12,68867,25.03,3,62.47,7
M3B2N7,6238,151,7,68874,25.03,2,62.47,4
M3B1V3,6239,151,18,68892,25.03,5,62.46,11
M3B2P8,6240,151,9,68901,25.03,2,62.46,6
M3B2N8,6241,151,9,68910,25.03,2,62.46,6
M3B1V2,6242,151,12,68922,25.03,3,62.46,7
M3B2N9,6243,151,16,68938,25.03,4,62.46,10
M3B1N5,6244,151,8,68946,25.03,2,62.46,5
M3B1N4,6245,151,8,68954,25.03,2,62.46,5
M3B1R2,6246,151,7,68961,25.03,2,62.45,4
M3B1S8,6247,151,3,68964,25.03,1,62.45,2
M3B2P9,6248,151,37,69001,25.12,9,62.05,23
L4L2X1,6249,151,1,69002,26.22,0,57.29,1
M2P1S9,6250,151,12,69014,25.02,3,62.48,7
M5N2G3,6251,151,20,69034,23.28,5,69.98,14
L3T4P6,6252,151,4,69038,24.41,1,65.08,3
M6A2H5,6253,151,2,69040,25.93,1,58.47,1
M6A1H3,6254,151,1,69041,25.93,0,58.47,1
M6A1H7,6255,151,2,69043,25.93,1,58.46,1
M9C5B3,6256,151,18,69061,25.65,5,59.67,11
M5P2W9,6257,151,12,69073,19.95,2,84.36,10
M6B2L2,6258,151,17,69090,27.83,5,50.22,9
M6A1L2,6259,151,4,69094,25.93,1,58.44,2
M6A1H5,6260,151,3,69097,25.93,1,58.44,2
M6A2K5,6261,151,19,69116,25.93,5,58.43,11
M6A2K6,6262,151,14,69130,25.93,4,58.43,8
M6A1K9,6263,151,27,69157,25.93,7,58.43,16
M6A2L1,6264,151,14,69171,25.93,4,58.43,8
M6A2J7,6265,151,34,69205,25.93,9,58.43,20
M6A2J1,6266,151,15,69220,25.93,4,58.43,9
M6A2G6,6267,151,17,69237,25.93,4,58.43,10
M6A2H1,6268,151,20,69257,25.93,5,58.43,12
M4W1J9,6269,151,15,69272,23.35,4,69.60,10
M6A2H6,6270,151,7,69279,25.93,2,58.42,4
M5M2J2,6271,151,18,69297,26.68,5,55.16,10
M4R1H3,6272,151,68,69365,24.66,17,63.90,43
M2J1J4,6273,151,7,69372,23.85,2,67.40,5
M5M4A9,6274,151,8,69380,26.67,2,55.18,4
M2J1X6,6275,151,16,69396,23.85,4,67.39,11
M2J1Z8,6276,151,3,69399,23.85,1,67.39,2
M5M2V3,6277,151,9,69408,26.67,2,55.17,5
M5M3M4,6278,151,11,69419,26.67,3,55.17,6
M2J4R6,6279,151,23,69442,23.85,5,67.39,15
M2J1X7,6280,151,32,69474,23.85,8,67.39,22
M2J4R8,6281,151,11,69485,23.85,3,67.39,7
M2J1X3,6282,151,27,69512,23.85,6,67.39,18
M2J1Y1,6283,151,18,69530,23.85,4,67.38,12
M2J1Y2,6284,151,16,69546,23.85,4,67.38,11
M2J1X4,6285,151,9,69555,23.85,2,67.38,6
M5M2V2,6286,151,14,69569,26.67,4,55.16,8
M2J4R9,6287,151,12,69581,23.85,3,67.38,8
M5M2R7,6288,151,9,69590,26.67,2,55.16,5
M4M2E8,6289,151,1,69591,26.39,0,56.37,1
M5N1G4,6290,151,29,69620,26.46,8,56.07,16
M5M3B6,6291,151,6,69626,27.76,2,50.43,3
M5M3B7,6292,151,19,69645,27.76,5,50.42,10
M5M3S7,6293,151,10,69655,27.76,3,50.42,5
M5M3J3,6294,151,20,69675,27.76,6,50.42,10
M5M3C1,6295,151,10,69685,27.76,3,50.42,5
M5M3S9,6296,151,18,69703,27.76,5,50.41,9
M5M3T1,6297,151,8,69711,27.76,2,50.41,4
M5M3B9,6298,151,16,69727,27.76,4,50.41,8
M5M3B8,6299,151,16,69743,27.76,4,50.41,8
M6S2V8,6300,151,8,69751,27.75,2,50.45,4
M2P1L8,6301,151,1,69752,23.92,0,67.04,1
L4L1N7,6302,151,10,69762,27.83,3,50.09,5
L3R0P9,6303,151,36,69798,26.77,10,54.68,20
L4L1N6,6304,151,26,69824,27.83,7,50.08,13
M2P1J5,6305,151,17,69841,23.93,4,66.97,11
M8Z3V7,6306,151,2,69843,26.66,1,55.14,1
M2P1M1,6307,151,16,69859,23.93,4,66.96,11
M6S1H5,6308,151,9,69868,27.74,2,50.45,5
L3T5L9,6309,151,44,69912,25.54,11,59.97,26
M6S5B1,6310,151,1,69913,27.74,0,50.44,1
L3T5S8,6311,151,10,69923,25.54,3,59.97,6
M4K1L9,6312,151,34,69957,24.45,8,64.69,22
M8Z3W5,6313,151,2,69959,26.66,1,55.11,1
L4L2Y8,6314,151,5,69964,27.82,1,50.08,3
M8Z3S9,6315,151,5,69969,26.66,1,55.10,3
M8Z2X5,6316,151,12,69981,26.66,3,55.10,7
M2P1L9,6317,151,10,69991,23.92,2,66.97,7
M2P1W5,6318,151,9,70000,23.92,2,66.97,6
M8Z2Y7,6319,151,7,70007,26.66,2,55.10,4
M8Z2X6,6320,151,18,70025,26.66,5,55.10,10
M8Z3W8,6321,151,13,70038,26.66,3,55.10,7
M2P1M2,6322,151,11,70049,23.92,3,66.97,7
L3T5S9,6323,151,1,70050,25.54,0,59.95,1
M2P1K7,6324,151,11,70061,23.92,3,66.96,7
M8Z3X1,6325,151,9,70070,26.66,2,55.09,5
M8Z3V5,6326,151,4,70074,26.66,1,55.09,2
M8Z3X2,6327,151,4,70078,26.66,1,55.09,2
M2P1V5,6328,151,10,70088,23.92,2,66.96,7
L3T5N4,6329,151,10,70098,25.53,3,59.97,6
M8Z3T1,6330,151,5,70103,26.66,1,55.07,3
M8Z2X7,6331,151,3,70106,26.66,1,55.07,2
M9C1N2,6332,151,2,70108,27.74,1,50.39,1
M5N2G9,6333,151,12,70120,22.33,3,73.83,9
M4K3A5,6334,151,6,70126,22.16,1,74.55,4
M8Z2Y9,6335,151,1,70127,26.66,0,55.06,1
M9B2P6,6336,151,8,70135,27.91,2,49.63,4
M9B2L8,6337,151,11,70146,27.91,3,49.62,5
M4V1X7,6338,151,35,70181,24.68,9,63.61,22
M9B2P7,6339,151,6,70187,27.91,2,49.62,3
L4J5K6,6340,151,18,70205,27.75,5,50.31,9
M9B2S3,6341,151,25,70230,27.91,7,49.62,12
M9B2R9,6342,151,14,70244,27.91,4,49.62,7
L4J5K5,6343,151,10,70254,27.75,3,50.31,5
L4J5K4,6344,151,18,70272,27.75,5,50.31,9
M9B2X2,6345,151,34,70306,27.91,9,49.62,17
M9C1M6,6346,151,1,70307,27.74,0,50.35,1
M9C2P1,6347,151,2,70309,27.74,1,50.35,1
M9B2S7,6348,151,3,70312,27.91,1,49.61,1
L4J7E1,6349,151,10,70322,24.50,2,64.38,6
L4J7H6,6350,151,10,70332,24.50,2,64.38,6
L4J7E2,6351,151,11,70343,24.50,3,64.37,7
L4J7H9,6352,151,9,70352,24.50,2,64.37,6
L4J7H1,6353,151,18,70370,24.50,4,64.37,12
L4J7H7,6354,151,11,70381,24.50,3,64.37,7
L4J7G5,6355,151,18,70399,24.50,4,64.37,12
L4J7G4,6356,151,10,70409,24.50,2,64.37,6
L4J7H2,6357,151,18,70427,24.50,4,64.37,12
M4W1W8,6358,151,17,70444,22.70,4,72.16,12
L4J7G9,6359,151,10,70454,24.50,2,64.37,6
M9B5R1,6360,151,3,70457,27.91,1,49.59,1
M4T1K2,6361,151,28,70485,23.47,7,68.82,19
M2K1S6,6362,151,2,70487,24.04,0,66.34,1
M2K1T1,6363,151,10,70497,24.04,2,66.33,7
L4J5H8,6364,151,10,70507,27.79,3,50.08,5
L4J5H2,6365,151,10,70517,27.79,3,50.08,5
L4J5H9,6366,151,18,70535,27.79,5,50.08,9
M2K1P1,6367,151,10,70545,24.04,2,66.32,7
M2K1X8,6368,151,9,70554,24.04,2,66.32,6
L4J5H5,6369,151,10,70564,27.79,3,50.07,5
L4J5K1,6370,151,18,70582,27.79,5,50.07,9
M2K1T2,6371,151,5,70587,24.04,1,66.32,3
L4J5J2,6372,151,10,70597,27.79,3,50.07,5
L4J5J3,6373,151,18,70615,27.79,5,50.07,9
M8Z2Y8,6374,151,1,70616,26.66,0,54.97,1
M2K1W4,6375,151,9,70625,24.04,2,66.32,6
L4J5J9,6376,151,18,70643,27.79,5,50.07,9
M6S3R2,6377,151,46,70689,27.78,13,50.11,23
M2K1T8,6378,151,19,70708,24.04,5,66.31,13
M2K1N8,6379,151,5,70713,24.04,1,66.31,3
M2K1X1,6380,151,14,70727,24.04,3,66.31,9
M2K1W9,6381,151,38,70765,24.04,9,66.31,25
M2K1V1,6382,151,20,70785,24.04,5,66.31,13
M2K1X7,6383,151,12,70797,24.04,3,66.31,8
M2K1T9,6384,151,9,70806,24.04,2,66.31,6
M2K1N4,6385,151,7,70813,24.04,2,66.31,5
M2K1V2,6386,151,10,70823,24.04,2,66.30,7
M2K1W7,6387,151,6,70829,24.04,1,66.30,4
M2K1N7,6388,151,3,70832,24.04,1,66.30,2
M2K1X2,6389,151,8,70840,24.04,2,66.30,5
M4S1P8,6390,151,68,70908,24.96,17,62.31,42
M2K1S8,6391,151,3,70911,24.04,1,66.29,2
M4V1G7,6392,151,48,70959,21.83,10,75.86,36
M6B2L1,6393,151,18,70977,27.70,5,50.42,9
M8Y2T9,6394,151,1,70978,26.62,0,55.09,1
M8V1P3,6395,151,1,70979,23.79,0,67.35,1
M6C3H9,6396,151,3,70982,23.37,1,69.14,2
L4J3A3,6397,151,97,71079,27.66,27,50.54,49
M9R1Y5,6398,151,29,71108,27.57,8,50.88,15
M4K3C3,6399,151,7,71115,25.78,2,58.64,4
L4J3B2,6400,151,23,71138,27.65,6,50.51,12
L4J3E5,6401,151,67,71205,27.65,19,50.51,34
L4J3E1,6402,151,6,71211,27.65,2,50.51,3
M8Y4H9,6403,151,9,71220,24.60,2,63.72,6
M2P1Y8,6404,151,4,71224,24.62,1,63.63,3
M2P1X9,6405,151,20,71244,24.62,5,63.63,13
M2P1X8,6406,151,10,71254,24.62,2,63.63,6
M2P1J3,6407,151,1,71255,24.62,0,63.63,1
M2P1K8,6408,151,20,71275,24.62,5,63.63,13
M2P1Y3,6409,151,13,71288,24.62,3,63.62,8
M2P1W3,6410,151,14,71302,24.62,3,63.62,9
M2P1Y1,6411,151,15,71317,24.62,4,63.62,10
M2P1Y5,6412,151,7,71324,24.62,2,63.62,4
M2P1Y9,6413,151,20,71344,24.62,5,63.62,13
M2P1Y7,6414,151,11,71355,24.62,3,63.62,7
M2L2G6,6415,151,13,71368,24.62,3,63.62,8
M4S1S8,6416,151,34,71402,25.93,9,57.94,20
M9C5S6,6417,151,56,71458,27.86,16,49.58,28
M9B1H5,6418,151,11,71469,27.11,3,52.83,6
M2P1G9,6419,151,4,71473,24.36,1,64.73,3
M2P1X2,6420,151,1,71474,24.36,0,64.73,1
M2P1E8,6421,151,12,71486,24.36,3,64.73,8
M2P1E6,6422,151,11,71497,24.36,3,64.73,7
M2P1C6,6423,151,15,71512,24.36,4,64.73,10
M2P1G7,6424,151,27,71539,24.36,7,64.73,17
M2P1Y4,6425,151,9,71548,24.36,2,64.72,6
M2P1C8,6426,151,14,71562,24.36,3,64.72,9
M2P1E7,6427,151,18,71580,24.36,4,64.72,12
M2P1C9,6428,151,17,71597,24.36,4,64.72,11
M2L1L1,6429,151,15,71612,24.36,4,64.72,10
M2P1C7,6430,151,12,71624,24.36,3,64.72,8
M2P1G8,6431,151,17,71641,24.36,4,64.72,11
M2L2G5,6432,151,14,71655,24.36,3,64.72,9
M2L1K9,6433,151,13,71668,24.36,3,64.72,8
M2L1B3,6434,151,6,71674,24.36,1,64.72,4
M2P1X5,6435,151,1,71675,24.36,0,64.72,1
M2L2G3,6436,151,5,71680,24.36,1,64.71,3
M2P1Y6,6437,151,2,71682,24.62,0,63.57,1
M9C4T2,6438,151,2,71684,29.84,1,40.96,1
M6B2H8,6439,151,18,71702,27.72,5,50.13,9
M2P1X1,6440,151,1,71703,24.36,0,64.69,1
M9C4T6,6441,151,10,71713,29.84,3,40.94,4
M2P1N3,6442,151,12,71725,24.79,3,62.82,8
M2P1N2,6443,151,18,71743,24.79,4,62.82,11
M9C4B4,6444,151,10,71753,29.84,3,40.94,4
M9C4P4,6445,151,10,71763,29.84,3,40.94,4
M9C4P2,6446,151,19,71782,29.84,6,40.94,8
M9C4G3,6447,151,11,71793,29.84,3,40.94,5
M9B3X1,6448,151,10,71803,27.10,3,52.81,5
M9C4G4,6449,151,22,71825,29.84,7,40.94,9
M9C4G5,6450,151,33,71858,29.84,10,40.94,14
M9C4B5,6451,151,7,71865,29.84,2,40.94,3
M9C4G6,6452,151,21,71886,29.84,6,40.94,9
M9C4P3,6453,151,17,71903,29.84,5,40.93,7
M9C4T9,6454,151,7,71910,29.84,2,40.93,3
M9C4T8,6455,151,2,71912,29.84,1,40.93,1
M9C4G1,6456,151,4,71916,29.84,1,40.92,2
M9C4G2,6457,151,2,71918,29.84,1,40.91,1
M9B0A9,6458,151,1,71919,27.67,0,50.30,1
M9C4T5,6459,151,2,71921,29.84,1,40.89,1
M2N1E9,6460,151,20,71941,27.62,6,50.49,10
M2N1E2,6461,151,29,71970,27.62,8,50.49,15
M2N1G1,6462,151,19,71989,27.62,5,50.49,10
M2N1E1,6463,151,21,72010,27.62,6,50.49,11
M2N1G9,6464,151,19,72029,27.62,5,50.49,10
M2N1G2,6465,151,25,72054,27.62,7,50.49,13
L4L5K5,6466,151,11,72065,25.78,3,58.45,6
L4J7X7,6467,151,38,72103,24.27,9,64.99,25
M4K1K3,6468,151,10,72113,25.78,3,58.44,6
M4K1L8,6469,151,36,72149,25.78,9,58.43,21
M4K1K8,6470,151,54,72203,25.78,14,58.43,32
M4K2X1,6471,151,8,72211,25.78,2,58.43,5
M8W4P7,6472,151,1,72212,29.77,0,41.14,0
M4K2Y8,6473,151,10,72222,25.78,3,58.43,6
M2P1M5,6474,151,23,72245,24.51,6,63.93,15
L3T1N2,6475,151,8,72253,24.89,2,62.27,5
M6S2Y7,6476,151,1,72254,24.70,0,63.09,1
M9C4T3,6477,151,1,72255,29.84,0,40.82,0
M2L2A5,6478,151,4,72259,24.70,1,63.08,3
M4K1L1,6479,151,2,72261,25.78,1,58.40,1
M2L1X9,6480,151,6,72267,24.70,1,63.08,4
M2L1Z7,6481,151,7,72274,24.70,2,63.07,4
M2L2A6,6482,151,4,72278,24.70,1,63.07,3
M2L1Z6,6483,151,6,72284,24.70,1,63.07,4
M2L2A4,6484,151,6,72290,24.70,1,63.07,4
M2L2A3,6485,151,9,72299,24.70,2,63.07,6
M2L2A9,6486,151,14,72313,24.70,3,63.07,9
M2L1X6,6487,151,16,72329,24.70,4,63.07,10
M2L1B6,6488,151,11,72340,24.70,3,63.07,7
M2L1Y7,6489,151,5,72345,24.70,1,63.07,3
M2L1Z9,6490,151,9,72354,24.70,2,63.07,6
M2L2A7,6491,151,9,72363,24.70,2,63.07,6
M2L1Z5,6492,151,11,72374,24.70,3,63.07,7
M4K1H9,6493,151,20,72394,24.95,5,61.98,12
M2L1X7,6494,151,5,72399,24.70,1,63.06,3
M2L2Y9,6495,151,1,72400,24.70,0,63.06,1
M4K1J5,6496,151,25,72425,24.95,6,61.98,15
M4K1J6,6497,151,21,72446,24.95,5,61.98,13
M4K1L5,6498,151,24,72470,24.95,6,61.98,15
M4K3K5,6499,151,10,72480,24.95,2,61.97,6
M4K1K6,6500,151,24,72504,24.95,6,61.97,15
M4K3R6,6501,151,10,72514,24.95,2,61.97,6
M4K1K7,6502,151,22,72536,24.95,5,61.97,14
M4K3K4,6503,151,9,72545,24.95,2,61.97,6
M4K3K6,6504,151,9,72554,24.95,2,61.97,6
M2L1X8,6505,151,3,72557,24.70,1,63.05,2
M2P1K9,6506,151,31,72588,24.41,8,64.30,20
M6P1H1,6507,151,7,72595,26.57,2,54.94,4
M9C3Z1,6508,151,4,72599,28.30,1,47.45,2
M9C4N2,6509,151,3,72602,28.30,1,47.45,1
M6P3E8,6510,151,23,72625,26.57,6,54.94,13
M6P2Y9,6511,151,26,72651,26.57,7,54.94,14
L4L0B1,6512,151,24,72675,27.69,7,50.08,12
L4L0A9,6513,151,5,72680,27.69,1,50.08,3
M9C4L6,6514,151,2,72682,28.30,1,47.44,1
M9C4N1,6515,151,19,72701,28.30,5,47.43,9
M9C4P5,6516,151,10,72711,28.30,3,47.43,5
M9C4M7,6517,151,41,72752,28.30,12,47.43,19
M9C3Y7,6518,151,16,72768,28.30,5,47.43,8
M9C4M6,6519,151,15,72783,28.30,4,47.43,7
M9C4M9,6520,151,3,72786,28.30,1,47.42,1
M9C4N3,6521,151,9,72795,28.30,3,47.42,4
M9C4L9,6522,151,2,72797,28.30,1,47.42,1
M9C4P8,6523,151,12,72809,28.29,3,47.44,6
M9C4L8,6524,151,9,72818,28.29,3,47.43,4
M9C4A1,6525,151,19,72837,28.29,5,47.43,9
M9C3Z9,6526,151,19,72856,28.29,5,47.43,9
M9C4N5,6527,151,32,72888,28.29,9,47.43,15
M9C4A5,6528,151,20,72908,28.29,6,47.42,9
M9C4A4,6529,151,11,72919,28.29,3,47.42,5
M9C4M8,6530,150,2,72921,28.30,1,47.38,1
M4V1E4,6531,150,60,72981,23.91,14,66.38,40
M9C4L7,6532,150,1,72982,28.29,0,47.39,0
L3T1N4,6533,150,1,72983,24.81,0,62.46,1
M6B3E3,6534,150,5,72988,23.02,1,70.20,4
L3T2W1,6535,150,2,72990,24.81,0,62.44,1
M6S3T2,6536,150,33,73023,23.06,8,70.03,23
L4J6K8,6537,150,19,73042,26.45,5,55.33,11
M6B3E5,6538,150,7,73049,23.02,2,70.19,5
M6B3C6,6539,150,7,73056,23.02,2,70.19,5
M6B3E2,6540,150,5,73061,23.02,1,70.18,4
M6B1A2,6541,150,36,73097,23.02,8,70.18,25
M6B1A4,6542,150,6,73103,23.02,1,70.18,4
M6B1J1,6543,150,5,73108,23.02,1,70.18,4
M6P2T7,6544,150,6,73114,22.37,1,72.99,4
M4A2G9,6545,150,6,73120,23.97,1,66.06,4
L3T2W3,6546,150,2,73122,24.81,0,62.42,1
L3T2V3,6547,150,3,73125,24.81,1,62.42,2
L4J7R7,6548,150,39,73164,24.63,10,63.20,25
M3H3T9,6549,150,5,73169,22.87,1,70.82,4
M6B1A5,6550,150,3,73172,23.02,1,70.17,2
M4V2H9,6551,150,1,73173,26.89,0,53.40,1
M3H4A4,6552,150,12,73185,22.87,3,70.82,8
M5M2V9,6553,150,7,73192,27.61,2,50.28,4
M8Z3C2,6554,150,44,73236,24.87,11,62.15,27
M6B1H9,6555,150,6,73242,23.02,1,70.16,4
M5M2Y3,6556,150,14,73256,27.61,4,50.28,7
M5M2W9,6557,150,15,73271,27.61,4,50.28,8
M3H5R4,6558,150,28,73299,22.87,6,70.81,20
M4K2Y9,6559,150,7,73306,25.74,2,58.38,4
M5M2W1,6560,150,15,73321,27.61,4,50.27,8
M3H5R1,6561,150,26,73347,22.87,6,70.81,18
M3H3X3,6562,150,9,73356,22.87,2,70.81,6
M3H5V2,6563,150,5,73361,22.87,1,70.81,4
M3H4A1,6564,150,6,73367,22.87,1,70.81,4
M5M2X1,6565,150,5,73372,27.61,1,50.27,3
M3H5R2,6566,150,15,73387,22.87,3,70.81,11
M3H5V7,6567,150,6,73393,22.87,1,70.81,4
M3H3T8,6568,150,9,73402,22.87,2,70.81,6
L3T2V9,6569,150,3,73405,24.81,1,62.40,2
M4K1J2,6570,150,26,73431,25.74,7,58.37,15
M4K2Y7,6571,150,8,73439,25.74,2,58.37,5
M4K1L4,6572,150,31,73470,25.74,8,58.36,18
M4K3C8,6573,150,12,73482,25.74,3,58.36,7
M4K3C7,6574,150,10,73492,25.74,3,58.36,6
L3T2W2,6575,150,3,73495,24.81,1,62.38,2
M5M4G6,6576,150,2,73497,27.61,1,50.24,1
L4J5L1,6577,150,15,73512,26.80,4,53.73,8
L4L8S1,6578,150,39,73551,27.65,11,50.04,20
M5M3K1,6579,150,3,73554,27.08,1,52.48,2
M5M1V8,6580,150,28,73582,27.08,8,52.48,15
M5M1Y6,6581,150,25,73607,27.08,7,52.48,13
M5M3K5,6582,150,11,73618,27.08,3,52.48,6
L3T2X7,6583,150,6,73624,25.04,2,61.30,4
M2N2L6,6584,150,3,73627,26.33,1,55.70,2
M6S1A3,6585,150,5,73632,25.39,1,59.78,3
M4W1T6,6586,150,3,73635,24.37,1,64.19,2
M4W1S4,6587,150,3,73638,24.37,1,64.18,2
M4W1W3,6588,150,4,73642,24.37,1,64.18,3
M4W3V6,6589,150,4,73646,24.37,1,64.17,3
M2P1W8,6590,150,12,73658,24.76,3,62.48,7
M4W1R1,6591,150,11,73669,24.37,3,64.17,7
M4W1T8,6592,150,8,73677,24.37,2,64.17,5
M4W2R1,6593,150,4,73681,24.37,1,64.17,3
M4W1R6,6594,150,10,73691,24.37,2,64.16,6
M4W2R6,6595,150,3,73694,24.37,1,64.16,2
M4W2S5,6596,150,11,73705,24.37,3,64.16,7
M4W2N7,6597,150,8,73713,24.37,2,64.16,5
M4W1R2,6598,150,9,73722,24.37,2,64.16,6
M4W2S6,6599,150,3,73725,24.37,1,64.16,2
M2N6V9,6600,150,1,73726,22.27,0,73.25,1
M4W2P9,6601,150,3,73729,24.37,1,64.15,2
L3T5H7,6602,150,19,73748,25.33,5,59.97,11
L3T5N1,6603,150,46,73794,25.33,12,59.97,28
L3T5N2,6604,150,18,73812,25.33,5,59.97,11
L3T5N7,6605,150,9,73821,25.33,2,59.97,5
L3T5H6,6606,150,26,73847,25.33,7,59.97,16
L3T5N8,6607,150,11,73858,25.33,3,59.96,7
L3T5L3,6608,150,6,73864,25.33,2,59.96,4
M5V2N2,6609,150,6,73870,23.55,1,67.65,4
M4T1A5,6610,150,20,73890,24.30,5,64.38,13
M4T3B3,6611,150,14,73904,24.30,3,64.38,9
M4T1B2,6612,150,12,73916,24.30,3,64.38,8
M4T3B5,6613,150,8,73924,24.30,2,64.38,5
M4T2B2,6614,150,9,73933,24.30,2,64.38,6
M4T1B3,6615,150,30,73963,24.30,7,64.38,19
M4T1A2,6616,150,8,73971,24.30,2,64.38,5
M4T2B5,6617,150,9,73980,24.30,2,64.37,6
M2N6Y3,6618,150,1,73981,22.25,0,73.25,1
L4L7R9,6619,150,18,73999,26.53,5,54.70,10
M5R1N5,6620,150,32,74031,23.15,7,69.34,22
L3T5K9,6621,150,3,74034,25.32,1,59.94,2
L3T5L2,6622,150,6,74040,25.32,2,59.93,4
L3T5L4,6623,150,13,74053,25.32,3,59.93,8
M9B6K8,6624,150,78,74131,25.76,20,58.02,45
L3T5P5,6625,150,7,74138,25.32,2,59.92,4
L3T5L8,6626,150,15,74153,25.32,4,59.92,9
L4H0J1,6627,150,32,74185,27.60,9,50.03,16
L4H0H8,6628,150,22,74207,27.60,6,50.03,11
L3T5L1,6629,150,5,74212,25.32,1,59.90,3
L3T2V4,6630,150,2,74214,24.78,0,62.23,1
M4V1Y4,6631,150,2,74216,27.39,1,50.91,1
L3T5K8,6632,150,2,74218,25.32,1,59.88,1
M5M4N9,6633,150,1,74219,27.48,0,50.52,1
L3T4J1,6634,150,5,74224,25.61,1,58.61,3
L3T4G3,6635,150,15,74239,25.61,4,58.61,9
M5P2W5,6636,150,4,74243,27.39,1,50.90,2
M4V2W5,6637,150,16,74259,27.39,4,50.89,8
M5P2W6,6638,150,21,74280,27.39,6,50.89,11
M4V1Y5,6639,150,10,74290,27.39,3,50.89,5
M4V2W4,6640,150,18,74308,27.39,5,50.89,9
M6S3X7,6641,150,37,74345,27.41,10,50.80,19
M6S3V8,6642,150,35,74380,27.41,10,50.80,18
M6S2E3,6643,150,11,74391,27.41,3,50.79,6
L3T4N4,6644,150,3,74394,25.32,1,59.84,2
M2P1M4,6645,150,19,74413,23.93,5,65.84,13
M5M3J2,6646,150,1,74414,27.48,0,50.45,1
L4J3M5,6647,150,4,74418,26.76,1,53.56,2
M5M3H8,6648,150,4,74422,27.48,1,50.44,2
M5M3B3,6649,150,7,74429,27.48,2,50.43,4
M5M3J1,6650,150,25,74454,27.48,7,50.42,13
M5M3G3,6651,150,16,74470,27.48,4,50.42,8
M5M3A1,6652,150,12,74482,27.48,3,50.42,6
M5M3G4,6653,150,14,74496,27.48,4,50.42,7
M5M3B4,6654,150,6,74502,27.48,2,50.42,3
M5M3J4,6655,150,7,74509,27.48,2,50.42,4
M5M3B5,6656,150,6,74515,27.48,2,50.41,3
M4W2T7,6657,150,20,74535,22.98,5,69.90,14
L4J6K9,6658,150,18,74553,25.17,5,60.41,11
L4J6N3,6659,150,10,74563,25.17,3,60.41,6
L4J6K3,6660,150,14,74577,25.17,4,60.41,8
L4J6K2,6661,150,11,74588,25.17,3,60.41,7
L4J6J1,6662,150,10,74598,25.17,3,60.41,6
L4J6J8,6663,150,18,74616,25.17,5,60.41,11
L4J6J9,6664,150,18,74634,25.17,5,60.41,11
L4J6K1,6665,150,10,74644,25.17,3,60.40,6
M5M3S8,6666,150,1,74645,27.48,0,50.39,1
L4J6J7,6667,150,9,74654,25.17,2,60.40,5
M2P1L7,6668,150,31,74685,23.93,7,65.76,20
M6B1T3,6669,150,2,74687,25.49,1,59.00,1
M6B1T6,6670,150,13,74700,25.49,3,59.00,8
M6C1Y5,6671,150,4,74704,27.42,1,50.64,2
M6C1Y8,6672,150,6,74710,27.42,2,50.63,3
M6B1T4,6673,150,12,74722,25.49,3,58.99,7
M4S1B3,6674,150,107,74829,24.09,26,65.05,70
M6C3B1,6675,150,19,74848,27.42,5,50.62,10
M6C3C3,6676,150,20,74868,27.42,5,50.62,10
M6C3E5,6677,150,15,74883,27.42,4,50.62,8
M6C3C4,6678,150,20,74903,27.42,5,50.62,10
M6C3A9,6679,150,16,74919,27.42,4,50.62,8
M6C1Y7,6680,150,7,74926,27.42,2,50.61,4
M4V1W1,6681,150,18,74944,23.43,4,67.87,12
M8Z2Y6,6682,150,1,74945,26.36,0,55.09,1
L4J7T6,6683,150,37,74982,26.05,10,56.43,21
M9B1N8,6684,150,1,74983,27.19,0,51.49,1
M2L2S4,6685,150,21,75004,23.92,5,65.66,14
M2L2T7,6686,150,18,75022,23.92,4,65.66,12
M2L2R7,6687,150,19,75041,23.92,5,65.66,12
M2L2S7,6688,150,14,75055,23.92,3,65.66,9
M2L2S8,6689,150,50,75105,23.92,12,65.66,33
M2L2P2,6690,150,16,75121,23.92,4,65.66,11
M2L2R8,6691,150,19,75140,23.92,5,65.66,12
M2L2T4,6692,150,7,75147,23.92,2,65.65,5
M2L2S2,6693,150,3,75150,23.92,1,65.65,2
M2L2S3,6694,150,15,75165,23.92,4,65.65,10
M9B4K4,6695,150,1,75166,27.19,0,51.48,1
M2L2S1,6696,150,2,75168,23.92,0,65.65,1
M2K2H5,6697,150,17,75185,25.84,4,57.30,10
M2K2J3,6698,150,3,75188,25.84,1,57.30,2
M2K2H1,6699,150,17,75205,25.84,4,57.30,10
M2K2H8,6700,150,23,75228,25.84,6,57.30,13
M2K2G1,6701,150,9,75237,25.84,2,57.29,5
M9B1L9,6702,150,6,75243,27.19,2,51.44,3
M9B1R9,6703,150,7,75250,27.19,2,51.44,4
M9B4J9,6704,150,11,75261,27.19,3,51.44,6
M9B4N6,6705,150,22,75283,27.19,6,51.44,11
M9B4N1,6706,150,14,75297,27.19,4,51.44,7
M9B1S1,6707,150,6,75303,27.19,2,51.43,3
M9B4M6,6708,150,14,75317,27.19,4,51.43,7
M9B4M9,6709,150,19,75336,27.19,5,51.43,10
M9B4M8,6710,150,9,75345,27.19,2,51.43,5
M2K2J2,6711,150,5,75350,25.84,1,57.28,3
M9B4K2,6712,150,10,75360,27.19,3,51.43,5
L4J7J7,6713,150,18,75378,25.30,5,59.61,11
L4J7H4,6714,150,18,75396,25.30,5,59.61,11
M8W2N5,6715,150,2,75398,29.55,1,41.20,1
M8W4T2,6716,150,8,75406,29.55,2,41.20,3
M8W4T6,6717,150,4,75410,29.55,1,41.19,2
M8W2J7,6718,150,4,75414,29.55,1,41.19,2
M8W4T5,6719,150,4,75418,29.55,1,41.19,2
M8W4T4,6720,150,5,75423,29.55,1,41.19,2
M8W4S2,6721,150,9,75432,29.55,3,41.19,4
M8W2K7,6722,150,16,75448,29.55,5,41.19,7
M8W4V2,6723,150,27,75475,29.55,8,41.19,11
M8W2K6,6724,150,15,75490,29.55,4,41.19,6
M8W4T3,6725,150,8,75498,29.55,2,41.19,3
M8W2P5,6726,150,11,75509,29.55,3,41.19,5
M8W4S5,6727,150,7,75516,29.55,2,41.18,3
M8W2N6,6728,150,16,75532,29.55,5,41.18,7
M8W2N7,6729,150,13,75545,29.55,4,41.18,5
M8W4N8,6730,150,8,75553,29.55,2,41.18,3
M6S3R3,6731,150,3,75556,27.42,1,50.41,2
M6B1N1,6732,150,16,75572,27.30,4,50.93,8
M8W4S4,6733,150,4,75576,29.55,1,41.18,2
M6B1R3,6734,150,14,75590,27.30,4,50.93,7
M8W2J8,6735,150,5,75595,29.55,1,41.17,2
M4G2A8,6736,150,12,75607,25.80,3,57.42,7
M6S1V7,6737,150,6,75613,27.42,2,50.39,3
M4V1E6,6738,150,3,75616,24.02,1,65.12,2
M8W2N4,6739,150,2,75618,29.55,1,41.16,1
M8W2J4,6740,150,1,75619,29.55,0,41.16,0
M4G2H4,6741,150,17,75636,26.39,4,54.85,9
M6S3R5,6742,150,26,75662,27.42,7,50.39,13
M6S1T5,6743,150,6,75668,27.42,2,50.38,3
M6S1V6,6744,150,11,75679,27.42,3,50.38,6
M6S3L6,6745,150,34,75713,27.42,9,50.38,17
M6S3L7,6746,150,4,75717,27.42,1,50.38,2
M6S3R1,6747,150,37,75754,27.42,10,50.38,19
M4G1K1,6748,150,10,75764,26.39,3,54.84,5
M8W4P1,6749,150,14,75778,29.54,4,41.19,6
M6S1T4,6750,150,4,75782,27.42,1,50.38,2
M6S2V6,6751,150,5,75787,27.40,1,50.46,3
M6S1H6,6752,150,7,75794,27.40,2,50.46,4
M6S2V9,6753,150,8,75802,27.40,2,50.46,4
M6S2V5,6754,150,14,75816,27.40,4,50.46,7
M6S2W2,6755,150,14,75830,27.40,4,50.45,7
M6S1K9,6756,150,6,75836,27.40,2,50.45,3
M6S2X8,6757,150,20,75856,27.40,5,50.45,10
M6S2X7,6758,150,2,75858,27.40,1,50.45,1
M6S2V3,6759,150,21,75879,27.40,6,50.45,11
M6S2W9,6760,150,17,75896,27.40,5,50.45,9
M6S1G8,6761,150,3,75899,27.40,1,50.45,2
M9B4K8,6762,150,18,75917,23.51,4,67.30,12
M6S1G9,6763,150,6,75923,27.40,2,50.44,3
M6S1L1,6764,150,1,75924,27.40,0,50.44,1
M6S1Z1,6765,150,1,75925,27.42,0,50.35,1
L4J7Y8,6766,150,34,75959,25.28,9,59.62,20
M6S1L2,6767,150,2,75961,27.40,1,50.42,1
M2N2J6,6768,150,1,75962,27.71,0,49.08,0
L4L7R7,6769,150,10,75972,26.43,3,54.61,5
M6S3V9,6770,150,36,76008,26.43,10,54.61,20
M6S1J3,6771,150,10,76018,25.62,3,58.11,6
M5N1N4,6772,150,28,76046,26.62,7,53.77,15
M5N1N2,6773,150,26,76072,26.62,7,53.77,14
M5M2P8,6774,150,24,76096,27.04,6,51.95,12
M2N1C1,6775,150,9,76105,27.71,2,49.03,4
M2N2J7,6776,150,4,76109,27.71,1,49.03,2
M2N1A5,6777,150,11,76120,27.71,3,49.03,5
M2N1C9,6778,150,19,76139,27.71,5,49.03,9
M2N1A7,6779,150,9,76148,27.71,2,49.03,4
M2N1E3,6780,150,19,76167,27.71,5,49.03,9
M2N1A6,6781,150,21,76188,27.71,6,49.03,10
M2N2J3,6782,150,25,76213,27.71,7,49.03,12
M2N1B6,6783,150,20,76233,27.71,6,49.03,10
M2N2J4,6784,150,23,76256,27.71,6,49.02,11
M2N1B9,6785,150,15,76271,27.71,4,49.02,7
M6C1K8,6786,150,2,76273,24.67,0,62.19,1
M2N1A8,6787,150,5,76278,27.71,1,49.01,2
M4G1N1,6788,150,17,76295,27.45,5,50.14,9
M4G1P1,6789,150,16,76311,27.45,4,50.14,8
M4G1M8,6790,150,19,76330,27.45,5,50.14,10
M4G1J5,6791,150,12,76342,27.45,3,50.14,6
M5N1M6,6792,150,28,76370,26.61,7,53.77,15
M4G1J3,6793,150,21,76391,27.45,6,50.13,11
M4G1T2,6794,150,9,76400,27.45,2,50.13,5
M4G1P3,6795,150,18,76418,27.45,5,50.13,9
M4G3S4,6796,150,20,76438,27.45,5,50.13,10
M4G1M9,6797,150,25,76463,27.45,7,50.13,13
M4G1J4,6798,150,20,76483,27.45,5,50.13,10
M4G1N2,6799,150,13,76496,27.45,4,50.13,7
M6C2Z8,6800,150,35,76531,24.67,9,62.17,22
M2N1B7,6801,150,2,76533,27.71,1,48.99,1
L3T5H2,6802,150,37,76570,25.26,9,59.58,22
M9A3L7,6803,150,2,76572,26.07,1,56.06,1
M8Y0A9,6804,150,14,76586,24.30,3,63.73,9
L3T4J2,6805,150,3,76589,25.55,1,58.31,2
M4R1E6,6806,150,42,76631,24.63,10,62.29,26
M6S1Y9,6807,150,6,76637,26.40,2,54.62,3
M6S1Y7,6808,150,8,76645,26.40,2,54.61,4
L4L7R8,6809,150,9,76654,26.39,2,54.63,5
M5N1E5,6810,150,1,76655,26.61,0,53.67,1
L4L7S2,6811,150,9,76664,26.39,2,54.62,5
M4W1Z9,6812,150,38,76702,22.34,8,72.16,27
M5A2R3,6813,150,1,76703,24.28,0,63.74,1
M8Y4H8,6814,150,12,76715,24.28,3,63.74,8
M4C2X9,6815,150,6,76721,27.27,2,50.76,3
M4C2Z9,6816,150,5,76726,27.27,1,50.76,3
M4C3M5,6817,150,17,76743,27.27,5,50.75,9
M4C3A2,6818,150,7,76750,27.27,2,50.75,4
M4C3H5,6819,150,15,76765,27.27,4,50.75,8
M4C2Z7,6820,150,3,76768,27.27,1,50.75,2
M4C3N9,6821,150,16,76784,27.27,4,50.75,8
M4C3N8,6822,150,14,76798,27.27,4,50.75,7
M4C3L2,6823,150,17,76815,27.27,5,50.75,9
M4C3M6,6824,150,16,76831,27.27,4,50.75,8
M4C3H6,6825,150,14,76845,27.27,4,50.75,7
M2R1T2,6826,150,1,76846,27.37,0,50.31,1
M4C3L3,6827,150,11,76857,27.27,3,50.75,6
M4C2Y1,6828,150,3,76860,27.27,1,50.75,2
M4C3A3,6829,150,5,76865,27.27,1,50.73,3
M4V1G2,6830,150,77,76942,23.31,18,67.88,52
M9C3M3,6831,150,13,76955,30.17,4,38.16,5
M9C3L6,6832,150,20,76975,30.17,6,38.15,8
M9C3G4,6833,150,18,76993,30.17,5,38.15,7
M9C2P2,6834,149,2,76995,27.33,1,50.45,1
M4T2E1,6835,149,1,76996,27.50,0,49.71,0
M9C2Y6,6836,149,2,76998,30.17,1,38.14,1
L4L4Z4,6837,149,21,77019,27.42,6,50.05,11
L4L3A1,6838,149,2,77021,27.57,1,49.39,1
M4S1J1,6839,149,1,77022,24.64,0,62.07,1
M9C2G5,6840,149,3,77025,27.33,1,50.42,2
L4L1M8,6841,149,6,77031,27.57,2,49.38,3
L4L2Z5,6842,149,6,77037,27.57,2,49.37,3
M2R1R3,6843,149,2,77039,27.37,1,50.24,1
L4L2C1,6844,149,2,77041,27.57,1,49.37,1
M9C3M2,6845,149,3,77044,30.17,1,38.11,1
M3B3S2,6846,149,20,77064,24.72,5,61.72,12
L4L1M7,6847,149,1,77065,27.57,0,49.37,0
M9C2B5,6848,149,7,77072,27.33,2,50.41,4
M2R1L9,6849,149,8,77080,27.37,2,50.24,4
M2R1K6,6850,149,27,77107,27.37,7,50.24,14
M2R1K7,6851,149,24,77131,27.37,7,50.24,12
M9C1M9,6852,149,2,77133,27.33,1,50.41,1
M2R1J9,6853,149,25,77158,27.37,7,50.24,13
L4L2Z6,6854,149,7,77165,27.57,2,49.37,3
M9C2B7,6855,149,13,77178,27.33,4,50.41,7
M9C2B8,6856,149,15,77193,27.33,4,50.41,8
M9C2G3,6857,149,16,77209,27.33,4,50.41,8
M2R1L8,6858,149,30,77239,27.37,8,50.23,15
L4L3H1,6859,149,4,77243,27.57,1,49.37,2
M2R1J8,6860,149,25,77268,27.37,7,50.23,13
M9C2K9,6861,149,25,77293,27.33,7,50.40,13
M2R1H6,6862,149,28,77321,27.37,8,50.23,14
M2R1R1,6863,149,8,77329,27.37,2,50.23,4
M9C1Z7,6864,149,14,77343,27.33,4,50.40,7
M9C2K7,6865,149,14,77357,27.33,4,50.40,7
M9C2G4,6866,149,17,77374,27.33,5,50.40,9
M9C2G7,6867,149,21,77395,27.33,6,50.40,11
M9C2B6,6868,149,6,77401,27.33,2,50.40,3
M9C2H4,6869,149,9,77410,27.33,2,50.40,5
M9C2G6,6870,149,17,77427,27.33,5,50.40,9
M9C1Z5,6871,149,9,77436,27.33,2,50.40,5
L4L1M9,6872,149,16,77452,27.57,4,49.36,8
M5A3A6,6873,149,2,77454,25.03,1,60.36,1
M9C1M8,6874,149,10,77464,27.33,3,50.40,5
M4K1K4,6875,149,39,77503,25.49,10,58.37,23
L4L2N4,6876,149,10,77513,27.57,3,49.35,5
M9A3S9,6877,149,6,77519,28.11,2,47.01,3
L4L4Z7,6878,149,29,77548,27.41,8,50.05,15
L4L2N6,6879,149,5,77553,27.57,1,49.35,2
L4L2Y4,6880,149,5,77558,27.57,1,49.35,2
M9A3T2,6881,149,14,77572,28.11,4,47.01,7
M9A2Y7,6882,149,11,77583,28.11,3,47.00,5
L4L1M5,6883,149,2,77585,27.57,1,49.33,1
M9A3B4,6884,149,2,77587,28.11,1,46.99,1
M5A3C2,6885,149,9,77596,25.03,2,60.33,5
M5A3A7,6886,149,7,77603,2.03,2,60.32,4
M5A3C8,6887,149,8,77611,25.03,2,60.32,5
M9B2S1,6888,149,2,77613,24.74,0,61.56,1
M9B5P6,6889,149,1,77614,24.74,0,61.56,1
M5R2E5,6890,149,22,77636,21.74,5,74.55,16
M4K2X2,6891,149,10,77646,25.46,3,58.43,6
L3T4W9,6892,149,28,77674,25.26,7,59.29,17
M9R3K3,6893,149,3,77677,27.19,1,50.91,2
L4L7V7,6894,149,15,77692,26.64,4,53.29,8
M9B5P5,6895,149,2,77694,24.74,0,61.52,1
L4L7V6,6896,149,10,77704,26.64,3,53.28,5
M4W1W9,6897,149,9,77713,22.28,2,72.17,6
M9B2S4,6898,149,4,77717,24.74,1,61.51,2
M4J0A1,6899,149,32,77749,28.58,9,44.87,14
M9R3H1,6900,149,2,77751,27.19,1,50.89,1
M9R1Z1,6901,149,19,77770,27.19,5,50.89,10
M3B3B6,6902,149,32,77802,24.02,8,64.61,21
M4J3L2,6903,149,24,77826,27.36,7,50.14,12
M4J3G7,6904,149,31,77857,27.36,8,50.14,16
M5P2B8,6905,149,13,77870,26.78,3,52.65,7
M5P2A4,6906,149,18,77888,26.78,5,52.65,9
M4J1C8,6907,149,6,77894,27.36,2,50.13,3
M5P2C9,6908,149,12,77906,26.78,3,52.64,6
M6P1R7,6909,149,10,77916,27.36,3,50.12,5
M6P1L7,6910,149,9,77925,27.36,2,50.12,5
M6P3A3,6911,149,32,77957,27.36,9,50.12,16
M6P1L8,6912,149,8,77965,27.36,2,50.11,4
M2P1B8,6913,149,1,77966,22.21,0,72.41,1
M6S3R6,6914,149,40,78006,26.32,11,54.61,22
M4N3N2,6915,149,1,78007,22.21,0,72.41,1
M2J1E6,6916,149,3,78010,25.78,1,56.94,2
M2J1C3,6917,149,6,78016,25.78,2,56.94,3
M6P2Z5,6918,149,2,78018,27.36,1,50.09,1
M4N2G2,6919,149,1,78019,22.21,0,72.40,1
M2J5H1,6920,149,1,78020,25.77,0,56.97,1
M2P1P3,6921,149,6,78026,22.21,1,72.39,4
M4N3E5,6922,149,8,78034,22.21,2,72.39,6
M2P1P4,6923,149,5,78039,22.21,1,72.39,4
M4N3P8,6924,149,6,78045,22.21,1,72.39,4
M2J1H7,6925,149,5,78050,25.78,1,56.92,3
M2J1H3,6926,149,4,78054,25.78,1,56.92,2
M2J1C9,6927,149,5,78059,25.78,1,56.92,3
M2J1H9,6928,149,7,78066,25.78,2,56.92,4
M2P1P6,6929,149,10,78076,22.21,2,72.39,7
M4N3P9,6930,149,5,78081,22.21,1,72.39,4
M4N2G5,6931,149,17,78098,22.21,4,72.39,12
M2P1A3,6932,149,10,78108,22.21,2,72.39,7
M2J1C8,6933,149,17,78125,25.78,4,56.92,10
M2P1B6,6934,149,72,78197,22.21,16,72.39,52
M4N2W8,6935,149,3,78200,22.21,1,72.39,2
M4N2H6,6936,149,5,78205,22.21,1,72.39,4
M2J1E5,6937,149,4,78209,25.78,1,56.92,2
M2P1A2,6938,149,18,78227,22.21,4,72.39,13
M2J1H2,6939,149,11,78238,25.78,3,56.92,6
M2P1P1,6940,149,6,78244,22.21,1,72.38,4
M2P1B1,6941,149,8,78252,22.21,2,72.38,6
M2L1L4,6942,149,10,78262,22.21,2,72.38,7
M2L1L5,6943,149,9,78271,22.21,2,72.38,7
M4N2H4,6944,149,12,78283,22.21,3,72.38,9
M2P1V8,6945,149,4,78287,22.21,1,72.38,3
M8Y2T5,6946,149,2,78289,27.33,1,50.20,1
M2J1C7,6947,149,15,78304,25.78,4,56.92,9
M2P1P7,6948,149,10,78314,22.21,2,72.38,7
M2J1E9,6949,149,6,78320,25.78,2,56.92,3
M2P1B2,6950,149,2,78322,22.21,0,72.38,1
M2J1J1,6951,149,3,78325,25.78,1,56.92,2
M4N2H5,6952,149,2,78327,22.21,0,72.38,1
M2J1E8,6953,149,7,78334,25.78,2,56.91,4
M2P1P2,6954,149,9,78343,22.21,2,72.38,7
M4N2G4,6955,149,1,78344,22.21,0,72.38,1
M4N2W6,6956,149,6,78350,22.21,1,72.38,4
L3T7J4,6957,149,8,78358,25.20,2,59.42,5
M6S4H4,6958,149,15,78373,24.34,4,63.15,9
M4N2W7,6959,149,5,78378,22.21,1,72.37,4
M2P1P5,6960,149,5,78383,22.21,1,72.37,4
L3T7H5,6961,149,9,78392,25.20,2,59.42,5
M8Z2L1,6962,149,8,78400,27.33,2,50.19,4
M8Z3S6,6963,149,11,78411,27.33,3,50.18,6
M8Z3S5,6964,149,12,78423,27.33,3,50.18,6
M8Z2N8,6965,149,19,78442,27.33,5,50.18,10
M8Z3P5,6966,149,10,78452,27.33,3,50.18,5
M8Z3Z9,6967,149,8,78460,27.33,2,50.18,4
M8Z2M9,6968,149,15,78475,27.33,4,50.18,8
M8Z2M5,6969,149,3,78478,27.33,1,50.18,2
M8Z2K5,6970,149,3,78481,27.33,1,50.18,2
M8Z4G9,6971,149,2,78483,27.33,1,50.18,1
M8Z2K7,6972,149,31,78514,27.33,8,50.18,16
M8Z2N1,6973,149,2,78516,27.33,1,50.18,1
M8Z4G8,6974,149,14,78530,27.33,4,50.18,7
M8Z2M8,6975,149,8,78538,27.33,2,50.18,4
M8Z2L2,6976,149,8,78546,27.33,2,50.17,4
M8Z2K1,6977,149,26,78572,27.33,7,50.17,13
M8Z2K4,6978,149,3,78575,27.33,1,50.17,2
M8Z2N5,6979,149,10,78585,27.33,3,50.17,5
M8Z2M3,6980,149,2,78587,27.33,1,50.17,1
M8Z2N6,6981,149,7,78594,27.33,2,50.16,4
M8Z2K8,6982,149,10,78604,27.33,3,50.16,5
M2J1J2,6983,149,1,78605,25.78,0,56.88,1
M4K2N9,6984,149,11,78616,24.94,3,60.51,7
M2P1A9,6985,149,16,78632,22.20,4,72.38,12
M8Z4A1,6986,149,2,78634,27.33,1,50.16,1
M2P1A1,6987,149,1,78635,22.20,0,72.38,1
M8Z2K6,6988,149,3,78638,27.33,1,50.16,2
M8Z4A2,6989,149,2,78640,27.33,1,50.15,1
M8Z2M7,6990,149,2,78642,27.33,1,50.15,1
M6S2K6,6991,149,15,78657,26.15,4,55.26,8
L3T7H9,6992,149,13,78670,25.19,3,59.42,8
M6C2X8,6993,149,11,78681,27.34,3,50.10,6
M6S3J2,6994,149,18,78699,22.74,4,70.02,13
M2P1V6,6995,149,1,78700,22.21,0,72.32,1
M4R1T7,6996,149,14,78714,27.41,4,49.78,7
M4R1T9,6997,149,2,78716,27.41,1,49.78,1
M4R1T2,6998,149,19,78735,27.41,5,49.78,9
M2L2P6,6999,149,3,78738,25.07,1,59.90,2
M2L2T6,7000,149,54,78792,25.07,14,59.90,32
M9B3X2,7001,149,9,78801,26.70,2,52.82,5
M9P1Z7,7002,149,1,78802,27.30,0,50.22,1
M9B6J5,7003,149,11,78813,26.70,3,52.82,6
L3T4G4,7004,149,8,78821,25.36,2,58.62,5
M9B6J6,7005,149,8,78829,26.70,2,52.81,4
M9B3W8,7006,149,2,78831,26.70,1,52.81,1
L4H1G2,7007,149,42,78873,27.27,11,50.34,21
M5M1A3,7008,149,25,78898,27.40,7,49.77,12
M9B1J9,7009,149,1,78899,26.70,0,52.80,1
M9P3V9,7010,149,10,78909,27.30,3,50.20,5
M9P3C8,7011,149,15,78924,27.30,4,50.20,8
M9P1P3,7012,149,34,78958,27.30,9,50.20,17
M9P3V1,7013,149,9,78967,27.30,2,50.20,5
M9P3C9,7014,149,5,78972,27.30,1,50.20,3
M9P3E1,7015,149,10,78982,27.30,3,50.20,5
M9P1P2,7016,149,24,79006,27.30,7,50.19,12
M9P1N9,7017,149,21,79027,27.30,6,50.19,11
M9P3B5,7018,149,8,79035,27.30,2,50.19,4
M9P3C2,7019,149,1,79036,27.30,0,50.17,1
M5A2T2,7020,149,45,79081,23.50,11,66.63,30
M5P3J4,7021,149,1,79082,27.31,0,50.12,1
M3B3S1,7022,149,20,79102,24.45,5,62.47,12
M9R2Z7,7023,149,2,79104,27.26,1,50.28,1
M6C1R4,7024,149,5,79109,27.31,1,50.03,3
M6C1T2,7025,149,3,79112,27.31,1,50.03,2
M6C3B4,7026,149,7,79119,27.31,2,50.03,4
M6C1S6,7027,149,16,79135,27.31,4,50.02,8
M6C3E9,7028,149,17,79152,27.31,5,50.02,9
M6C3B3,7029,149,15,79167,27.31,4,50.02,8
M6C1R2,7030,149,15,79182,27.31,4,50.02,8
M9R3A5,7031,149,4,79186,27.26,1,50.23,2
M9R2Z3,7032,149,4,79190,27.26,1,50.23,2
M9R3A8,7033,149,8,79198,27.26,2,50.23,4
M9R1J9,7034,149,7,79205,27.26,2,50.23,4
M9R1J8,7035,149,6,79211,27.26,2,50.23,3
M9R1H9,7036,149,7,79218,27.26,2,50.23,4
M6R2A5,7037,149,16,79234,24.16,4,63.66,10
M6R1G8,7038,149,34,79268,24.16,8,63.65,22
M9R2Z1,7039,149,21,79289,27.26,6,50.22,11
M9R3A4,7040,149,2,79291,27.26,1,50.22,1
M9R2Z5,7041,149,8,79299,27.26,2,50.22,4
M9R2P5,7042,149,16,79315,27.26,4,50.22,8
M6R2E6,7043,149,11,79326,24.16,3,63.65,7
M9W3Z7,7044,149,11,79337,27.25,3,50.27,6
M9R1H8,7045,149,6,79343,27.26,2,50.22,3
M9R1K7,7046,149,16,79359,27.26,4,50.22,8
M8X1Z9,7047,149,8,79367,26.97,2,51.48,4
M9R1L3,7048,149,24,79391,27.26,7,50.22,12
M9R1K6,7049,149,22,79413,27.26,6,50.22,11
M9W3Z5,7050,149,1,79414,27.25,0,50.26,1
M9R3A9,7051,149,11,79425,27.26,3,50.22,6
M9R1J5,7052,149,16,79441,27.26,4,50.22,8
M9R1J2,7053,149,5,79446,27.26,1,50.22,3
M9R1J6,7054,149,9,79455,27.26,2,50.22,5
M6C3B2,7055,149,2,79457,27.31,1,50.00,1
M9W3Z8,7056,149,23,79480,27.25,6,50.26,12
M9W3Z2,7057,149,2,79482,27.25,1,50.26,1
M9W3Z6,7058,149,20,79502,27.25,5,50.26,10
M9W2G1,7059,149,29,79531,27.25,8,50.26,15
M9W2G3,7060,149,12,79543,27.25,3,50.26,6
M9W3Z3,7061,149,14,79557,27.25,4,50.25,7
M9W2E3,7062,149,16,79573,27.25,4,50.25,8
M9R2Z6,7063,149,3,79576,27.26,1,50.21,2
M9R3A7,7064,149,5,79581,27.26,1,50.21,3
M8X2A7,7065,149,13,79594,26.97,4,51.47,7
M8X1M9,7066,149,10,79604,26.97,3,51.46,5
M9R2Z2,7067,149,3,79607,27.26,1,50.20,2
L4J5G1,7068,149,18,79625,25.88,5,56.17,10
M9R3A6,7069,149,1,79626,27.26,0,50.20,1
M9R1J7,7070,149,3,79629,27.26,1,50.19,2
M9C5C5,7071,149,54,79683,25.43,14,58.12,31
M9R2Z4,7072,149,1,79684,27.26,0,50.19,1
M9R1K5,7073,149,1,79685,27.26,0,50.19,1
M9R1M1,7074,149,1,79686,27.26,0,50.18,1
M4S2S8,7075,149,38,79724,25.19,10,59.15,22
L4J7X2,7076,149,39,79763,25.08,10,59.61,23
M4S2R6,7077,149,1,79764,24.49,0,62.17,1
L4L1X4,7078,149,1,79765,27.55,0,48.91,0
L4L1M6,7079,149,15,79780,27.55,4,48.90,7
L4J7S1,7080,149,38,79818,26.86,10,51.88,20
M5V0A9,7081,149,181,79999,27.45,50,49.31,89
M5M2S4,7082,149,25,80024,26.99,7,51.30,13
L4J5M6,7083,149,18,80042,25.86,5,56.18,10
M9P2B4,7084,149,19,80061,27.24,5,50.20,10
L4J5L7,7085,149,10,80071,25.86,3,56.18,6
L4J5M3,7086,149,18,80089,25.86,5,56.18,10
M5A2M6,7087,149,8,80097,24.09,2,63.84,5
M5A2M7,7088,149,10,80107,24.09,2,63.83,6
M9B2A2,7089,149,10,80117,27.21,3,50.31,5
M4S2V4,7090,149,8,80125,24.49,2,62.09,5
M4S1K7,7091,149,22,80147,24.49,5,62.08,14
M4S1K5,7092,149,45,80192,24.49,11,62.08,28
M4S2T6,7093,149,14,80206,24.49,3,62.08,9
M4S2R4,7094,149,13,80219,24.49,3,62.08,8
M4S1H8,7095,149,10,80229,24.49,2,62.08,6
M4S1M7,7096,149,52,80281,24.49,13,62.08,32
M4S1H6,7097,149,5,80286,24.49,1,62.08,3
M4J3L3,7098,149,6,80292,27.25,2,50.12,3
M4S1K6,7099,149,16,80308,24.49,4,62.08,10
M4J1C6,7100,149,6,80314,27.25,2,50.12,3
M4S2V3,7101,149,13,80327,24.49,3,62.08,8
M4S2W5,7102,149,10,80337,24.49,2,62.08,6
M4S2T7,7103,149,10,80347,24.49,2,62.07,6
M2L1Y9,7104,149,7,80354,25.05,2,59.65,4
M2L1W5,7105,149,9,80363,25.05,2,59.65,5
M9C4K9,7106,149,2,80365,27.10,1,50.76,1
M2L1X3,7107,149,3,80368,25.05,1,59.64,2
M2L1W6,7108,149,6,80374,25.05,2,59.64,4
M2L1Y2,7109,149,6,80380,25.05,2,59.64,4
M2L1Y5,7110,149,4,80384,25.05,1,59.64,2
M2L1Y1,7111,149,3,80387,25.05,1,59.64,2
M2L1W4,7112,149,7,80394,25.05,2,59.64,4
M6B3C4,7113,149,2,80396,26.47,1,53.49,1
M2L1Y4,7114,149,13,80409,25.05,3,59.64,8
M2L1V8,7115,149,12,80421,25.05,3,59.64,7
M2L1Z1,7116,149,9,80430,25.05,2,59.64,5
M2L1Z3,7117,149,5,80435,25.05,1,59.63,3
L4L1S5,7118,149,10,80445,25.98,3,55.61,6
M2L2A8,7119,149,16,80461,25.05,4,59.63,10
M2L1X4,7120,149,10,80471,25.05,3,59.63,6
M2L2A2,7121,149,4,80475,25.05,1,59.63,2
M2L1V3,7122,149,8,80483,25.05,2,59.63,5
M2L1V6,7123,149,5,80488,25.05,1,59.63,3
M2L1W7,7124,149,3,80491,25.05,1,59.63,2
M2L1V4,7125,149,9,80500,25.05,2,59.63,5
M2L1X2,7126,149,3,80503,25.05,1,59.63,2
L4H1G3,7127,149,30,80533,27.24,8,50.14,15
M2L1W8,7128,149,3,80536,25.05,1,59.63,2
M2L2W7,7129,149,7,80543,25.05,2,59.63,4
M2L2X5,7130,149,2,80545,25.05,1,59.63,1
M2L2W8,7131,149,3,80548,25.05,1,59.62,2
M2L2W9,7132,149,3,80551,25.05,1,59.62,2
M2L1Y3,7133,149,4,80555,25.05,1,59.62,2
M9A5E2,7134,149,56,80611,27.25,15,50.08,28
L4J5J6,7135,149,15,80626,27.24,4,50.11,8
M2L1V5,7136,149,2,80628,25.05,1,59.60,1
M6B1H6,7137,149,9,80637,26.47,2,53.43,5
M4K2Z1,7138,149,40,80677,23.87,10,64.69,26
L4J3P1,7139,149,1,80678,26.43,0,53.59,1
L4J3N7,7140,149,23,80701,26.43,6,53.58,12
L4J8N1,7141,149,8,80709,26.43,2,53.58,4
L4J3N2,7142,149,23,80732,26.43,6,53.58,12
L4J3N5,7143,149,29,80761,26.43,8,53.58,16
L4J3N3,7144,149,22,80783,26.43,6,53.58,12
L4J3N1,7145,149,12,80795,26.43,3,53.58,6
L4J3M9,7146,149,3,80798,26.43,1,53.58,2
L4J8B7,7147,149,7,80805,26.43,2,53.57,4
L4J9E7,7148,149,4,80809,26.43,1,53.57,2
M6S3Y1,7149,149,35,80844,27.07,9,50.80,18
M6S3V6,7150,149,32,80876,27.07,9,50.80,16
L4J3M4,7151,149,2,80878,26.43,1,53.57,1
M6S1J1,7152,149,9,80887,25.38,2,58.11,5
M6S3A8,7153,149,37,80924,25.38,9,58.11,22
M6S3A9,7154,149,36,80960,25.38,9,58.11,21
M6S1V9,7155,149,3,80963,27.07,1,50.79,2
L4J3M1,7156,149,4,80967,26.42,1,53.60,2
L4J3M2,7157,149,7,80974,26.42,2,53.59,4
M8Y3E9,7158,149,1,80975,24.06,0,63.81,1
L4J3N4,7159,149,28,81003,26.42,7,53.58,15
L4J3N6,7160,149,19,81022,26.42,5,53.58,10
L4J3M3,7161,149,7,81029,26.42,2,53.58,4
M4K2Z2,7162,149,10,81039,23.92,2,64.40,6
L3T4J5,7163,149,10,81049,27.18,3,50.27,5
M6S1Z2,7164,149,1,81050,27.07,0,50.74,1
L3T4L6,7165,149,2,81052,27.18,1,50.25,1
L4H1C8,7166,149,38,81090,27.06,10,50.74,19
M2R1T4,7167,149,1,81091,25.90,0,55.76,1
M5R1M6,7168,149,15,81106,23.34,4,66.84,10
M8Y3E1,7169,149,7,81113,24.06,2,63.72,4
M5R1N3,7170,149,12,81125,23.34,3,66.84,8
M5R1N2,7171,149,15,81140,23.34,4,66.84,10
M5R2E3,7172,149,23,81163,23.34,5,66.83,15
M5R1P7,7173,149,7,81170,23.34,2,66.83,5
M4G1T7,7174,149,6,81176,27.22,2,50.00,3
M4G3S7,7175,149,5,81181,27.22,1,50.00,3
M4G2E9,7176,149,8,81189,27.22,2,49.99,4
M4G2G1,7177,149,15,81204,27.22,4,49.99,7
M2R3S8,7178,149,14,81218,25.90,4,55.71,8
M4G2H3,7179,149,21,81239,27.22,6,49.99,10
M4G3S6,7180,149,25,81264,27.22,7,49.99,12
M4G3S5,7181,149,17,81281,27.22,5,49.99,8
M2R1S8,7182,149,7,81288,25.90,2,55.71,4
M2R1A9,7183,149,20,81308,25.90,5,55.70,11
M4G1J6,7184,149,18,81326,27.22,5,49.98,9
M2R1S2,7185,149,8,81334,25.90,2,55.70,4
M2R1S5,7186,149,3,81337,25.90,1,55.70,2
M2R1A3,7187,149,18,81355,25.90,5,55.70,10
M2R1A8,7188,149,15,81370,25.90,4,55.70,8
M2R1A1,7189,149,48,81418,25.90,12,55.70,27
M2R1B9,7190,149,15,81433,25.90,4,55.70,8
L4L5K3,7191,149,11,81444,25.94,3,55.52,6
M4G1J7,7192,149,12,81456,27.22,3,49.98,6
M2R1B8,7193,149,15,81471,25.90,4,55.70,8
M5R3E5,7194,149,25,81496,24.46,6,61.93,15
L4L5K8,7195,149,18,81514,25.94,5,55.52,10
M2R1R9,7196,149,3,81517,25.90,1,55.69,2
M2R1E5,7197,149,6,81523,25.90,2,55.69,3
L3T5W3,7198,149,85,81608,25.06,21,59.33,50
M2R1T6,7199,149,1,81609,25.90,0,55.69,1
L4L6S4,7200,149,11,81620,24.57,3,61.45,7
L4L6R6,7201,149,10,81630,24.57,2,61.45,6
L4L6P8,7202,149,11,81641,24.57,3,61.45,7
L4L6R7,7203,149,15,81656,24.57,4,61.44,9
L4L6R4,7204,149,10,81666,24.57,2,61.44,6
L4L6S1,7205,149,11,81677,24.57,3,61.44,7
L4L6R9,7206,149,10,81687,24.57,2,61.44,6
L4L6R5,7207,149,15,81702,24.57,4,61.44,9
L4L6S3,7208,149,10,81712,24.57,2,61.44,6
L4L6R1,7209,149,10,81722,24.57,2,61.44,6
L4L2T8,7210,149,20,81742,24.57,5,61.44,12
L4L6S2,7211,149,18,81760,24.57,4,61.44,11
M4K1S4,7212,149,12,81772,24.59,3,61.35,7
L4L2R7,7213,149,4,81776,27.24,1,49.85,2
M4G2G2,7214,149,4,81780,27.21,1,49.98,2
L4J7T1,7215,149,46,81826,27.85,13,47.20,22
M6S3R7,7216,149,32,81858,26.14,8,54.61,17
L4L5K6,7217,149,17,81875,25.94,4,55.47,9
L4L2M3,7218,149,1,81876,27.24,0,49.83,0
L4L2M2,7219,149,1,81877,27.24,0,49.83,0
M8Y4H5,7220,149,37,81914,24.03,9,63.74,24
L4L2M5,7221,149,12,81926,27.24,3,49.83,6
L4L1S7,7222,149,3,81929,27.24,1,49.83,1
L4L2M6,7223,149,16,81945,27.24,4,49.83,8
M8Z3C1,7224,149,7,81952,26.02,2,55.11,4
L4L2M8,7225,149,5,81957,27.24,1,49.82,2
L3T4G1,7226,149,19,81976,25.43,5,57.64,11
M3A2J1,7227,149,5,81981,26.87,1,51.40,3
M3A1E2,7228,149,23,82004,26.87,6,51.39,12
M3A1E1,7229,149,34,82038,26.87,9,51.39,17
M3A1G2,7230,149,12,82050,26.87,3,51.39,6
M3A1J4,7231,149,18,82068,26.87,5,51.39,9
M8Y1G6,7232,149,1,82069,24.01,0,63.77,1
M8Y2Z3,7233,149,1,82070,24.01,0,63.77,1
M9B5G9,7234,149,2,82072,28.03,1,46.35,1
L4L5E3,7235,149,16,82088,27.13,4,50.24,8
M4K3S1,7236,149,16,82104,24.42,4,61.98,10
M9B5J2,7237,149,2,82106,28.03,1,46.33,1
M8Y3E8,7238,149,5,82111,24.01,1,63.74,3
M9B2W3,7239,149,2,82113,28.03,1,46.33,1
M9B2V2,7240,149,7,82120,28.03,2,46.33,3
M8Y4H3,7241,149,10,82130,24.01,2,63.74,6
M9B2N6,7242,149,9,82139,28.03,3,46.32,4
M8Y1G4,7243,149,15,82154,24.01,4,63.74,10
M9B2V9,7244,149,7,82161,28.03,2,46.32,3
M9B5H1,7245,149,3,82164,28.03,1,46.32,1
M9B2N3,7246,149,9,82173,28.03,3,46.32,4
M9B5N1,7247,149,15,82188,28.03,4,46.32,7
M9B2N9,7248,149,4,82192,28.03,1,46.32,2
M9B2P2,7249,149,10,82202,28.03,3,46.32,5
M4W1T5,7250,149,33,82235,23.91,8,64.17,21
M9B5H7,7251,149,17,82252,28.03,5,46.32,8
M9B2P1,7252,149,16,82268,28.03,4,46.32,7
M9B2V3,7253,149,5,82273,28.03,1,46.32,2
M9B2T6,7254,149,5,82278,28.03,1,46.32,2
M9B5G4,7255,149,14,82292,28.03,4,46.32,6
M9B2M9,7256,149,5,82297,28.03,1,46.32,2
M9B2T5,7257,149,6,82303,28.03,2,46.31,3
M4T1B1,7258,149,47,82350,23.86,11,64.38,30
M9B5M9,7259,149,2,82352,28.03,1,46.31,1
M4G3L3,7260,149,8,82360,26.69,2,52.12,4
M4G3P8,7261,149,7,82367,26.69,2,52.12,4
M9B5L5,7262,149,2,82369,28.03,1,46.31,1
M9B5J3,7263,149,6,82375,28.03,2,46.31,3
M4G3L2,7264,149,19,82394,26.69,5,52.12,10
M9B5L3,7265,149,3,82397,28.03,1,46.31,1
M4S2J6,7266,149,2,82399,24.68,0,60.82,1
M4G2R1,7267,149,20,82419,26.69,5,52.11,10
M9B5H9,7268,149,9,82428,28.03,3,46.31,4
M9B2T4,7269,149,2,82430,28.03,1,46.31,1
M4G2T5,7270,149,20,82450,26.69,5,52.11,10
M9B5L8,7271,149,4,82454,28.03,1,46.31,2
M9B5J1,7272,149,2,82456,28.03,1,46.31,1
M9B2S8,7273,149,6,82462,28.03,2,46.31,3
M9B2T3,7274,149,4,82466,28.03,1,46.30,2
M4G3L4,7275,149,9,82475,26.69,2,52.11,5
M9B5L4,7276,149,2,82477,28.03,1,46.30,1
L4L5G3,7277,149,15,82492,27.12,4,50.23,8
M4G2T6,7278,149,7,82499,26.69,2,52.10,4
M4G2V2,7279,148,4,82503,26.69,1,52.09,2
M9B5H8,7280,148,2,82505,28.03,1,46.29,1
M4S1T6,7281,148,25,82530,24.68,6,60.80,15
M4S1W2,7282,148,26,82556,24.68,6,60.80,16
M4S1V5,7283,148,66,82622,24.68,16,60.80,40
M4T2C5,7284,148,2,82624,23.69,0,65.08,1
M4T1T6,7285,148,1,82625,23.69,0,65.06,1
M4T2J2,7286,148,1,82626,23.69,0,65.06,1
M4T2C3,7287,148,2,82628,23.69,0,65.06,1
M4T1T3,7288,148,33,82661,23.69,8,65.06,21
M4T2K6,7289,148,7,82668,23.69,2,65.05,5
M4T1P4,7290,148,26,82694,23.69,6,65.05,17
M4T2J3,7291,148,2,82696,23.69,0,65.05,1
M4T1R6,7292,148,28,82724,23.69,7,65.05,18
M4T1R7,7293,148,7,82731,23.69,2,65.05,5
M4T1R8,7294,148,16,82747,23.69,4,65.05,10
M4T2J4,7295,148,8,82755,23.69,2,65.05,5
M4T2K5,7296,148,12,82767,23.69,3,65.05,8
M4W3A6,7297,148,9,82776,27.35,2,49.18,4
M4W3B5,7298,148,15,82791,27.35,4,49.18,7
M4W3A9,7299,148,18,82809,27.35,5,49.18,9
M4W2X3,7300,148,31,82840,27.35,8,49.18,15
L4J3G3,7301,148,25,82865,27.15,7,50.05,13
M4W3B1,7302,148,28,82893,27.35,8,49.18,14
M4W3A8,7303,148,16,82909,27.35,4,49.18,8
M4W2C2,7304,148,8,82917,27.35,2,49.18,4
M4T2J5,7305,148,1,82918,23.69,0,65.03,1
L3T3A7,7306,148,35,82953,27.02,9,50.61,18
M4W2X4,7307,148,29,82982,27.35,8,49.18,14
M4W2X1,7308,148,7,82989,27.35,2,49.17,3
M4W2E5,7309,148,3,82992,27.35,1,49.17,1
M4W3A7,7310,148,6,82998,27.35,2,49.17,3
M4N2T1,7311,148,20,83018,22.92,5,68.36,14
M5M2V8,7312,148,28,83046,26.77,7,51.65,14
M4S3G8,7313,148,1,83047,24.68,0,60.70,1
M9A3G9,7314,148,6,83053,24.57,1,61.16,4
L4J4T3,7315,148,10,83063,26.18,3,54.17,5
L4J4T4,7316,148,11,83074,26.18,3,54.17,6
M4S2T5,7317,148,33,83107,25.03,8,59.15,20
M5M2S3,7318,148,30,83137,26.75,8,51.69,16
M4G0A8,7319,148,10,83147,24.57,2,61.13,6
M2L1A2,7320,148,19,83166,23.08,4,67.57,13
L4J1Z4,7321,148,1,83167,26.99,0,50.62,1
M2K2Y6,7322,148,103,83270,25.97,27,55.03,57
M8W2R5,7323,148,1,83271,27.18,0,49.78,0
M4V2N4,7324,148,4,83275,26.64,1,52.10,2
M4V1H1,7325,148,2,83277,26.64,1,52.10,1
L4J1J5,7326,148,1,83278,26.99,0,50.57,1
M4V1W8,7327,148,1,83279,25.65,0,56.38,1
M4V3B8,7328,148,2,83281,25.65,1,56.38,1
M8W2L9,7329,148,6,83287,27.18,2,49.74,3
M8W2M6,7330,148,5,83292,27.18,1,49.74,2
M4V1H3,7331,148,15,83307,26.64,4,52.08,8
M5P2B9,7332,148,14,83321,26.57,4,52.38,7
M4V2N2,7333,148,6,83327,26.64,2,52.08,3
M8W4L4,7334,148,17,83344,27.18,5,49.73,8
M5V0G9,7335,148,1,83345,25.68,0,56.23,1
M8W2R9,7336,148,4,83349,27.18,1,49.73,2
M8W4J6,7337,148,16,83365,27.18,4,49.73,8
M4V2N5,7338,148,3,83368,26.64,1,52.07,2
M8W4H7,7339,148,19,83387,27.18,5,49.73,9
M8W4K7,7340,148,16,83403,27.18,4,49.73,8
M8W4H8,7341,148,18,83421,27.18,5,49.73,9
M4V2P3,7342,148,5,83426,26.64,1,52.07,3
M8W2R7,7343,148,6,83432,27.18,2,49.73,3
M8W4K6,7344,148,13,83445,27.18,4,49.73,6
M4V3C1,7345,148,3,83448,26.64,1,52.07,2
M8W4G8,7346,148,17,83465,27.18,5,49.73,8
M8W4J7,7347,148,14,83479,27.18,4,49.73,7
M8W4L3,7348,148,18,83497,27.18,5,49.73,9
M8W4L8,7349,148,16,83513,27.18,4,49.73,8
M8W2L7,7350,148,7,83520,27.18,2,49.72,3
M8W2M2,7351,148,5,83525,27.18,1,49.72,2
M4V2M1,7352,148,4,83529,26.64,1,52.06,2
M4V1V2,7353,148,2,83531,25.65,1,56.35,1
M4V2L3,7354,148,9,83540,25.65,2,56.35,5
M4V2P6,7355,148,8,83548,25.65,2,56.34,5
M4V2L5,7356,148,16,83564,25.65,4,56.34,9
M4V2P8,7357,148,11,83575,25.65,3,56.34,6
M4V2P5,7358,148,13,83588,25.65,3,56.34,7
M4V2L6,7359,148,15,83603,25.65,4,56.34,8
M6G0A1,7360,148,1,83604,27.09,0,50.10,1
M4V2S3,7361,148,6,83610,25.65,2,56.33,3
M4V1W7,7362,148,5,83615,25.65,1,56.32,3
M5A3E1,7363,148,8,83623,24.72,2,60.33,5
M5A1T6,7364,148,17,83640,24.72,4,60.32,10
M6N5J3,7365,148,9,83649,23.66,2,64.91,6
M8W2S2,7366,148,1,83650,27.18,0,49.65,0
M4V2P4,7367,148,1,83651,26.64,0,51.99,1
M2L2N7,7368,148,3,83654,24.81,1,59.91,2
M2L2L5,7369,148,8,83662,24.81,2,59.91,5
M4V1V1,7370,148,1,83663,25.65,0,56.26,1
M2L2N6,7371,148,17,83680,24.81,4,59.90,10
M2L2M1,7372,148,15,83695,24.81,4,59.90,9
M6E4W7,7373,148,55,83750,22.80,13,68.60,38
M2L2M8,7374,148,4,83754,24.81,1,59.89,2
M6E4W8,7375,148,24,83778,22.80,5,68.60,16
M6E1V3,7376,148,15,83793,22.80,3,68.60,10
M6E1V2,7377,148,12,83805,22.80,3,68.60,8
L4J7H8,7378,148,16,83821,25.16,4,58.37,9
M3B3H6,7379,148,1,83822,23.71,0,64.65,1
M6E1X5,7380,148,12,83834,22.80,3,68.60,8
M2L2L8,7381,148,2,83836,24.81,0,59.88,1
M6N4H4,7382,148,9,83845,26.88,2,50.91,5
M6S1C4,7383,148,7,83852,25.81,2,55.54,4
M6N1Z7,7384,148,26,83878,26.88,7,50.90,13
M6N1Z8,7385,148,21,83899,26.88,6,50.90,11
M6N2B2,7386,148,23,83922,26.88,6,50.90,12
M4K1J8,7387,148,24,83946,24.66,6,60.52,15
M6N4H7,7388,148,8,83954,26.88,2,50.90,4
M6N1Z6,7389,148,22,83976,26.88,6,50.89,11
M6N1Z5,7390,148,8,83984,26.88,2,50.89,4
M6N4K5,7391,148,3,83987,26.88,1,50.89,2
M8Y3C8,7392,148,7,83994,23.91,2,63.75,4
M3B3C7,7393,148,19,84013,23.71,5,64.62,12
M3B1W3,7394,148,20,84033,23.71,5,64.62,13
M3B1W1,7395,148,9,84042,23.71,2,64.62,6
M6N4K4,7396,148,3,84045,26.88,1,50.88,2
M3B1W2,7397,148,33,84078,23.71,8,64.61,21
M3B3B5,7398,148,39,84117,23.71,9,64.61,25
M8Y3E5,7399,148,6,84123,23.91,1,63.75,4
M6N2A9,7400,148,7,84130,26.88,2,50.88,4
M8Y1L6,7401,148,8,84138,23.91,2,63.74,5
M8Y1H5,7402,148,11,84149,23.91,3,63.74,7
M8Y2Z6,7403,148,6,84155,23.91,1,63.74,4
M8Y2Z4,7404,148,7,84162,23.91,2,63.74,4
M8Y1G5,7405,148,16,84178,23.91,4,63.74,10
M8Y2W8,7406,148,16,84194,23.91,4,63.74,10
M8Y3E4,7407,148,14,84208,23.91,3,63.74,9
M8Y3Y4,7408,148,23,84231,23.91,5,63.74,15
M8Y1H2,7409,148,30,84261,23.91,7,63.73,19
M8Y2W7,7410,148,12,84273,23.91,3,63.73,8
M8Y1G8,7411,148,42,84315,23.91,10,63.73,27
M8Y3E6,7412,148,5,84320,23.91,1,63.73,3
M8Y1L9,7413,148,7,84327,23.91,2,63.72,4
M8Y1H3,7414,148,6,84333,23.91,1,63.72,4
L3T1N3,7415,148,4,84337,24.91,1,59.38,2
M9B2S5,7416,148,7,84344,24.41,2,61.52,4
M9B5P2,7417,148,26,84370,24.41,6,61.52,16
M9B2M3,7418,148,16,84386,24.41,4,61.52,10
M9B5P4,7419,148,21,84407,24.41,5,61.52,13
M9B5N9,7420,148,33,84440,24.41,8,61.52,20
M9B2M1,7421,148,21,84461,24.41,5,61.52,13
M9B5P1,7422,148,14,84475,24.41,3,61.52,9
M9B5P3,7423,148,21,84496,24.41,5,61.51,13
M9B2P9,7424,148,23,84519,24.41,6,61.51,14
M9B2S6,7425,148,10,84529,24.41,2,61.51,6
M9B2S2,7426,148,4,84533,24.41,1,61.51,2
M6G3C5,7427,148,11,84544,23.95,3,63.50,7
M6G2A6,7428,148,19,84563,23.95,5,63.49,12
M6G2A7,7429,148,18,84581,23.95,4,63.49,11
M6G2A1,7430,148,18,84599,23.95,4,63.49,11
M6G2B4,7431,148,18,84617,23.95,4,63.49,11
M6C2C8,7432,148,63,84680,21.12,13,75.75,48
M6G3C7,7433,148,10,84690,23.95,2,63.49,6
M3H2H2,7434,148,15,84705,25.36,4,57.35,9
M3H3J1,7435,148,6,84711,25.36,2,57.35,3
M2L1E9,7436,148,2,84713,21.14,0,75.63,2
L4J7S9,7437,148,46,84759,27.70,13,47.20,22
M6P1R5,7438,148,8,84767,23.50,2,65.39,5
L3T3A4,7439,148,12,84779,27.14,3,49.62,6
M2L1E2,7440,148,3,84782,21.14,1,75.61,2
M2L1N2,7441,148,5,84787,21.14,1,75.61,4
M2L1H9,7442,148,5,84792,21.14,1,75.61,4
L3T2Z1,7443,148,21,84813,27.14,6,49.62,10
M2L1K1,7444,148,6,84819,21.14,1,75.61,5
M6P3A2,7445,148,2,84821,27.02,1,50.13,1
M2L1E8,7446,148,4,84825,21.14,1,75.61,3
M2L1E6,7447,148,7,84832,21.14,1,75.61,5
M2L1G4,7448,148,21,84853,21.14,4,75.60,16
M2L1M2,7449,148,2,84855,21.14,0,75.60,2
M2L1M9,7450,148,5,84860,21.14,1,75.60,4
M2L1H2,7451,148,20,84880,21.14,4,75.60,15
M2L1J9,7452,148,10,84890,21.14,2,75.60,8
M2L1H7,7453,148,8,84898,21.14,2,75.60,6
M2L1J8,7454,148,8,84906,21.14,2,75.60,6
M2L1J7,7455,148,10,84916,21.14,2,75.60,8
M2L1H6,7456,148,8,84924,21.14,2,75.60,6
M2L1L2,7457,148,8,84932,21.14,2,75.60,6
M2L1K8,7458,148,8,84940,21.14,2,75.60,6
M2L1H1,7459,148,22,84962,21.14,5,75.60,17
M2L1M4,7460,148,3,84965,21.14,1,75.60,2
M2L1M7,7461,148,3,84968,21.14,1,75.60,2
M2L1H4,7462,148,6,84974,21.14,1,75.60,5
M2L1N1,7463,148,4,84978,21.14,1,75.60,3
M2L1H5,7464,148,6,84984,21.14,1,75.60,5
M2L1M8,7465,148,5,84989,21.14,1,75.60,4
M2L1H3,7466,148,4,84993,21.14,1,75.60,3
M2L1H8,7467,148,4,84997,21.14,1,75.60,3
M2L1E5,7468,148,2,84999,21.14,0,75.59,2
M2L1G5,7469,148,3,85002,21.14,1,75.59,2
M2L1M5,7470,148,2,85004,21.14,0,75.59,2
M2L1M6,7471,148,1,85005,21.14,0,75.59,1
M6P1L6,7472,148,10,85015,27.02,3,50.11,5
M4S2K6,7473,148,7,85022,26.16,2,53.83,4
M4N1Y6,7474,148,34,85056,24.87,8,59.42,20
M4S1L9,7475,148,12,85068,26.16,3,53.82,6
M4S2K4,7476,148,13,85081,26.16,3,53.82,7
M4S1J6,7477,148,40,85121,26.16,10,53.82,22
M4S1L3,7478,148,54,85175,26.16,14,53.82,29
M6S1C3,7479,148,5,85180,25.49,1,56.70,3
M4P3B9,7480,148,1,85181,26.67,0,51.59,1
M2L1G3,7481,148,1,85182,21.14,0,75.53,1
M4W3S9,7482,148,74,85256,24.97,18,58.92,44
L3T4L3,7483,148,4,85260,25.03,1,58.62,2
L3T4H2,7484,148,15,85275,25.03,4,58.62,9
L4J7W1,7485,148,40,85315,27.32,11,48.70,19
L4J7T2,7486,148,47,85362,27.32,13,48.69,23
L3T4H3,7487,148,19,85381,25.03,5,58.61,11
M6P3A4,7488,148,28,85409,26.99,8,50.12,14
L3T1V1,7489,148,10,85419,27.13,3,49.51,5
M8Y1Z9,7490,148,9,85428,24.77,2,59.73,5
M4K1K9,7491,148,16,85444,25.07,4,58.43,9
M9B3G7,7492,148,1,85445,26.95,0,50.28,1
L4J5K7,7493,148,15,85460,26.86,4,50.67,8
L4J3E9,7494,148,24,85484,26.93,6,50.36,12
M6H3G9,7495,148,40,85524,21.25,9,74.97,30
L4L5S5,7496,148,10,85534,26.95,3,50.28,5
M4N2E4,7497,148,1,85535,25.56,0,56.30,1
L4L5S8,7498,148,10,85545,26.95,3,50.27,5
L4L5T3,7499,148,15,85560,26.95,4,50.27,8
M8Y4E5,7500,148,3,85563,24.77,1,59.71,2
L4L5T2,7501,148,10,85573,26.95,3,50.27,5
L4L5S2,7502,148,10,85583,26.95,3,50.27,5
L4L5S7,7503,148,16,85599,26.95,4,50.27,8
M6R2W3,7504,148,9,85608,27.00,2,50.05,5
M6R1N9,7505,148,18,85626,27.00,5,50.05,9
L4L5S9,7506,148,11,85637,26.95,3,50.26,6
L4L5S6,7507,148,11,85648,26.95,3,50.26,6
M6R1P8,7508,148,19,85667,27.00,5,50.04,10
M6R1P9,7509,148,16,85683,27.00,4,50.04,8
M6R1P1,7510,148,20,85703,27.00,5,50.04,10
M6R1R9,7511,148,23,85726,27.00,6,50.04,12
L3T3A6,7512,148,2,85728,27.13,1,49.47,1
M3B3M5,7513,148,1,85729,24.74,0,59.83,1
M6R2W5,7514,148,11,85740,27.00,3,50.04,6
L4K1R7,7515,148,2,85742,27.09,1,49.64,1
M6R2Z2,7516,148,5,85747,27.00,1,50.03,3
L3T4R3,7517,148,14,85761,25.19,4,57.87,8
L4J7E3,7518,148,18,85779,25.01,5,58.62,11
M2N7M1,7519,148,6,85785,25.89,2,54.79,3
L4L5T1,7520,148,18,85803,26.93,5,50.27,9
L4L5T4,7521,148,18,85821,26.93,5,50.27,9
L4L5P6,7522,148,18,85839,26.93,5,50.27,9
L4J9G2,7523,148,4,85843,26.16,1,53.60,2
L4J8N5,7524,148,7,85850,26.16,2,53.59,4
L4J8N6,7525,148,3,85853,26.16,1,53.58,2
M9B3W5,7526,148,13,85866,26.95,4,50.16,7
L4H1K5,7527,148,30,85896,26.98,8,50.03,15
L4J3P2,7528,148,34,85930,26.16,9,53.58,18
L4H2E1,7529,148,43,85973,26.98,12,50.02,22
M2L2T5,7530,148,40,86013,23.37,9,65.66,26
M2L2S9,7531,148,41,86054,23.37,10,65.66,27
L4J4Y4,7532,148,11,86065,26.51,3,52.05,6
L4J7C8,7533,148,18,86083,24.99,4,58.62,11
M4K1C3,7534,148,94,86177,24.98,23,58.65,55
M6S3K2,7535,148,7,86184,26.89,2,50.38,4
M5N2E2,7536,148,15,86199,25.57,4,56.07,8
L4J5J4,7537,148,15,86214,26.90,4,50.30,8
L4J5H6,7538,148,14,86228,26.90,4,50.29,7
L4L7X3,7539,148,9,86237,26.43,2,52.33,5
L4L7W9,7540,148,8,86245,26.43,2,52.32,4
L4L7X1,7541,148,11,86256,26.43,3,52.31,6
L4J5L8,7542,148,15,86271,26.36,4,52.60,8
L3T4K5,7543,148,17,86288,26.89,5,50.27,9
M8Y1E8,7544,148,53,86341,23.78,13,63.73,34
L4L4Z5,7545,148,14,86355,26.93,4,50.09,7
L4J8A5,7546,148,35,86390,25.20,9,57.57,20
L4L3Z2,7547,148,16,86406,26.86,4,50.37,8
L4L3Z8,7548,148,12,86418,26.86,3,50.37,6
L4L3G2,7549,148,1,86419,26.97,0,49.87,0
L4L2M1,7550,148,4,86423,26.97,1,49.86,2
L3T1M5,7551,148,10,86433,24.97,2,58.53,6
L3T1M3,7552,148,5,86438,24.97,1,58.53,3
L3T1V4,7553,148,14,86452,25.24,4,57.36,8
L3T2R6,7554,148,3,86455,24.97,1,58.52,2
L3T2P7,7555,148,10,86465,24.97,2,58.52,6
M8Z2K9,7556,148,2,86467,26.90,1,50.15,1
L4L3G1,7557,148,4,86471,26.97,1,49.85,2
M2K2H6,7558,148,43,86514,25.25,11,57.30,25
M6S2C9,7559,148,13,86527,26.15,3,53.40,7
L4L2L7,7560,148,5,86532,26.97,1,49.84,2
L4L7B8,7561,148,10,86542,26.97,3,49.84,5
L4L2M7,7562,148,5,86547,26.97,1,49.83,2
L3T2P5,7563,148,3,86550,24.97,1,58.49,2
L4L1V6,7564,148,2,86552,26.97,1,49.83,1
L3T3A5,7565,148,2,86554,27.15,1,49.05,1
L4L1V7,7566,148,3,86557,26.97,1,49.82,1
L4L3G3,7567,148,10,86567,26.97,3,49.82,5
L4L2N8,7568,148,4,86571,26.97,1,49.82,2
L4L2N9,7569,148,3,86574,26.97,1,49.82,1
L4L7C2,7570,148,10,86584,26.97,3,49.82,5
L4L3G4,7571,148,6,86590,26.97,2,49.82,3
L4L2M4,7572,148,2,86592,26.97,1,49.81,1
M2J3G6,7573,148,3,86595,24.64,1,59.89,2
M2J3G1,7574,148,8,86603,24.64,2,59.88,5
M2J3A9,7575,148,10,86613,24.64,2,59.88,6
M8W2L6,7576,148,7,86620,27.08,2,49.31,3
M2M0A2,7577,148,8,86628,25.30,2,57.02,5
M3H1X4,7578,148,1,86629,26.79,0,50.56,1
M2J3J8,7579,148,22,86651,24.64,5,59.87,13
M2J3K2,7580,148,14,86665,24.64,3,59.87,8
 


